上火的水果	橙子功效
橙子的好处	柚子功效
懒吃的水果	不检索
吃香蕉的好处	不检索
草莓和芒果的营养价值	不检索
借书的软件	电子书
电子书	kindle阅读器
kindle可以放多少书	kindle内存
电子书资源	电子书资源
kindle电子书资源	不检索
木瓜的好处	不检索
木瓜甜品	木瓜能做的甜品。
木瓜炖雪蛤	不检索
木瓜的功效	吃木瓜有木瓜有好处？
木瓜减肥	不检索
迪丽热巴	迪丽热巴
迪丽热巴	迪丽热巴代表作
迪丽热巴的作品	不检索
三生三世小说	唐七公子
迪丽热巴电视剧	不检索
杨洋	不检索
迪丽热巴和杨洋	不检索
荣耀	荣耀夫妇
迪丽热巴和迪士尼之约	不检索
杨洋和迪丽热巴的爱情	迪丽热巴在一起杨洋
旅游景点	旅游
哈尔滨冰雕	桂林山水
桂林山水甲天下	去桂林
桂林天气	桂林天气
桂林天气	不检索
家里嫌弃你	不检索
家里的家务	不检索
怎么讨好家长	不检索
三明治	不粘锅三明治
不粘锅三明治	不检索
养生的重要性	养生的重要性
粗粮的好处	粗粮的好处
吃水果的好处	不检索
苹果和芒果的营养价值	不检索
苹果和芒果的营养价值	不检索
新疆天气	不检索
脖子疼	脖子疼
脖子疼的原因	办公室常见病
办公室运动	办公室运动
办公室运动	不检索
谷爱凌	谷爱凌
谷爱凌滑雪	谷爱凌跳台滑雪
谷爱凌	谷爱凌为什么这么火
谷爱凌	谷爱凌有多优秀
谷爱凌的人生剧本	不检索
期末考试	考试放松
语文考试	不检索
语文考试	语文考前准备
语文考试技巧	不检索
语文考前复习	不检索
玩游戏的好处	不检索
炉石传说	炉石传说
炉石传说	不检索
适合女生玩的游戏	不检索
光遇	光遇
北京2022年冬奥会	不检索
谷爱凌	不检索
武大靖	武大靖
武大靖	任子威
滑冰都是东北那块的	滑冰都是东北人才
大熊猫	大熊猫
大熊猫保护	不检索
北京动物园	不检索
食铁兽	食铁兽
食铁兽	不检索
金丝猴	金丝猴
好看的网络小说	小说
玄幻小说	玄幻小说
雪中悍刀行资源	不检索
手机看玄幻小说	不检索
永夜君王	不检索
就业的好处	不检索
中国语言文学就业	中国语言文学就业前景
网文大牛	不检索
教师资格证	不检索
教师资格证考试时间	教师资格证每年考几次
教师资格证笔试	不检索
小猫小狗	不检索
猫和小狗的区别	狗狗热情
导盲犬	导盲犬品种
金毛	金毛养犬须知
金毛	不检索
济南市寒假时间	不检索
旅行的意义	不检索
哈尔滨冬季旅游	哈尔滨冬季旅游
三亚春节旅游	三亚冬季旅游
三亚旅游价格	三亚春节贵
三亚旅游淡季	不检索
电热毯	不检索
大学生活准备	宿舍用品
北京冬天的气候	北京冬天刮风
电热毯的作用	宿舍电热毯事故
宿舍电热毯安全吗	不检索
电热毯安全吗	不检索
第一模拟测验考多少分？	高考状元
择校	高考择校
北京的大学	清华大学
北京大学	北京大学
北京大学	北京大学好的专业
服部平次的男朋友	服部平次
柯南多少年了	名侦探柯南多少年了
未来老公	不检索
属狗今年桃花运	属狗2022桃花运
属狗4月份桃花运	不检索
属狗4月份桃花运	不检索
被裁员的原因	不检索
双减政策	双减政策
双减政策	不检索
找工作的方法	找工作
智联招聘简历	简历
作家	不检索
东野圭吾代表作	东野圭吾代表作
白夜行	白夜行剧情白夜行剧情
白夜行在哪里	在哪里可以买到白夜行在哪里可以买到白夜行
东野圭吾	不检索
星座	狮子座特点
假狮子	巨蟹座特点
巨蟹座相性怎么样	不检索
星座	不检索
星座的含义	有关星座的书籍
星座书	不检索
北京语言大学	不检索
北京语言大学	北京语言大学小联合国
考研专业	汉语国际教育硕士
汉语国际教育硕士	孔子学院北京语言大学
对外汉语老师	对外汉语老师
北京语言大学考研	不检索
北京语言大学	不检索
呦呦鹿鸣，食野之苹	呦呦鹿鸣，食野之苹
呦呦鹿鸣，食野之苹	短歌行
曹操的代表作	诗人曹操代表作
观沧海，龟虽寿	短歌行
我有嘉宾鼓瑟吹笙	不检索
最近上映的电影	新上映电影
老电影	经典电影
《放牛班的春天》	《放牛班的春天》
什么是音乐电影	什么是音乐电影
《海上钢琴师》	不检索
孩子学钢琴的好处	不检索
孩子学钢琴的原因	育儿
孩子学跳舞	不检索
佛山钢琴学校	附近钢琴培训
孩子学钢琴的好处	不检索
葡萄的颜色	葡萄
葡萄的味道	葡萄味道的描述
日照葡萄	日照葡萄
日照气候	淘宝水果
日照葡萄	哪里的葡萄最好吃
新疆葡萄	不检索
恋爱	不检索
右手和左手的区别	不检索
没有对象的单身狗	不检索
谈恋爱的好处	不检索
大学谈恋爱	谈恋爱的好处
济宁小吃	济宁小吃
衮州胡辣汤	衮州离河南近吗
衮州	不检索
糟鱼	糟鱼
糟鱼	不检索
薛之谦新歌	薛之谦新歌播放量
薛之谦的心愿	我的心愿，世界和平薛之谦
薛之谦火锅店	薛之谦火锅店
薛之谦火锅店	薛之谦火锅店地址
薛之谦火锅店	薛之谦，火锅店，上海
薛之谦	不检索
小东c零食	不检索
好吃的东西会让人变胖	不检索
乐事薯片	乐事薯片热量
泡芙	不检索
吃零食的危害	不检索
老友记	《老友记》
老友记中的男主角	老友记瑞秋
莫妮卡	老友记莫妮卡
老友记瑞秋	不检索
老友记的剧情	不检索
星座	不检索
阳历3月21日是什么星座	双鱼座温柔
水逆	水逆双鱼
附近的景点	附近的旅游景点
澳门美食	澳门美食
澳门蛋挞	澳门蛋挞
放松的方法	不检索
推荐的小说	priest作品
priest的作品	不检索
p大的小说	《镇魂》
《杀破狼》	不检索
早上新闻	不检索
看新闻的软件	可以看新闻的手机软件
最近的新闻	最近的新闻
最近的新闻	不检索
社会新闻	最近的社会新闻
摄影的好处	不检索
拍日出的技巧	拍摄日出技巧
日出时太阳在云雾中喷薄而出的景象	不检索
适合拍日出日落的景色	不检索
玉皇顶	不检索
香水瓶	不检索
香奈儿	香奈儿香水
香奈儿的味道	不检索
香奈儿香水价格	香奈儿香水的价格。
香奈儿的香水。	不检索
摩羯座	摩羯座
幸运色	幸运色
幸运色	不检索
双鱼座	双鱼座幸运色
陶白白	陶白白
开封天气	河南旅游
河南美食	河南美食
胡辣汤	不检索
胡辣汤	做胡辣汤
河南美食	不检索
长津湖电影	长津湖影评
长津湖电影	长津湖演员
易烊千玺	易烊千玺长津湖
易烊千玺	易烊千玺
易烊千玺青春修炼手册	青春修炼手册易烊千玺
白羊座和什么星座最配	白羊座和哪个星座最配
白羊座和狮子射手最配吗	不检索
水瓶座今日运势	今日水瓶座星座运势
水瓶座的工资	不检索
买买买	不检索
眉笔品牌。	眉笔的品牌。
什么是砍刀眉笔？	什么是砍刀眉笔？
植村秀砍刀眉笔	不检索
植村秀砍刀眉笔多少钱	植村秀砍刀眉笔多少钱？
什么一百根眉笔	不检索
韩语温柔	不检索
海岸村恰恰恰	海岸村恰恰恰
韩语学习	韩语学习技巧
韩语学习	不检索
韩语儿童歌曲	韩语儿童歌曲
韩语儿童歌曲	不检索
严歌苓	严歌苓作品
小姨多鹤电视剧	小姨多鹤电视剧
严歌苓的演技	不检索
历史上专一的皇帝	历史上专一的皇帝
明朝朱佑	不检索
男女比例	不检索
人工智能专业学什么？	人工智能专业学什么？
人工智能专业有前景吗？	人工智能专业有前景吗？
人工智能的前景	不检索
人工智能专业的前景	不检索
人工智能专业的前景	不检索
日照天气	日照天气
《三生三世十里桃花》	杨幂
杨幂	不检索
神雕侠侣杨幂	神雕侠侣杨幂
郭襄	郭襄
007	不检索
007电影	不检索
詹姆斯邦德	不检索
詹姆斯邦德	不检索
007第一部	不检索
室内养花	室内养花，有什么推荐的
紫罗兰	紫罗兰是什么
紫罗兰	不检索
紫罗兰	不检索
室内养花的好处	不检索
人世间电视剧	人世间电视剧
人世间演员阵容	不检索
武林外传	武林外传电视剧
武林外传祝无双	不检索
家有儿女电视剧	不检索
篮球鞋品牌。	质量好的篮球鞋牌子
李宁的篮球鞋质量怎么样	李宁的篮球鞋质量怎么样
李宁的篮球鞋	不检索
东沙群岛商场	在哪里可以买到篮球鞋
名鞋库里	不检索
今年的新年伊始	不检索
过年为什么这么疲惫	过年和父母吵架
和父母沟通的方法	大城市结婚晚的原因
过年找对象	和父母沟通的方法
复工	不检索
开心麻花	不检索
开心麻花	不检索
开心麻花新出的电影	开心麻花的新电影
开心麻花	不检索
开心麻花成员	开心麻花成员
开心麻花	不检索
针灸推拿	中医针灸推拿历史
针灸推拿	针灸推拿
针灸推拿	针灸推拿治疗
针灸推拿拍法	中医针灸推拿拍法
中医馆	正宗的中医药馆
陕西中医药大学	不检索
治愈的小说	治愈的小说
言叶之庭	《言叶之庭》
《言叶之庭》	不检索
《蛤蟆先生去看心理医生》	不检索
《蛤蟆先生去看心理医生》	不检索
《也许你该找个人聊聊》	《德雷尔一家》
平顶山美食	河南平顶山的美食
平顶山手抓饼	平顶山手抓饼
平顶山手抓饼口味	不检索
北京烤鸭	不检索
平顶山美食	不检索
水浒传	水浒传
不喜欢西游记	不喜欢西游记
行政管理专业学什么	行政管理水浒传
甘肃省教育厅	与教育厅沟通协商
大学行政管理专业教学大纲	经典名著知识
关于名著的书籍	不检索
黄芪的作用	黄芪药
失血体虚黄芪配方	失血体虚黄芪配方
贫血黄芪当归水	贫血黄芪当归水
黄芪当归水喝几周	黄芪当归水喝几周
黄芪当归水喝几周	黄芪当归水喝几周
黄芪当归水喝几周	不检索
三毛	三毛荷西
沙漠之恋	不检索
云南气候	不检索
云南花市	云南花市
斗南花市	不检索
古巨基	古巨基
情深深雨蒙蒙电视剧	情深深雨蒙蒙
情深深雨蒙蒙电视剧	情深深雨蒙蒙剧情
情深深雨蒙蒙赵薇导演	赵薇导演
致我们终将逝去的青春	不检索
华语女歌手	不检索
邓紫棋	不检索
邓紫棋的歌	邓紫棋的歌
张碧晨	张碧晨的歌
《年轮》是哪个电视剧的主题曲	不检索
名著推荐	不检索
西游记	四大名著
红楼梦	红楼梦
红楼梦诗	不检索
红楼梦的注意事项	名著推荐
父母的育儿经验	不检索
父母逼着相亲	被父母逼着相亲
父母沟通的方法	不检索
27岁的父母	27岁不结婚
为什么27岁不能结婚	不检索
27岁能结婚	不检索
27岁能结婚	不检索
慢性胃炎	慢性胃炎
慢性胃炎预防	慢性胃炎预防
幽门螺旋杆菌	慢性胃炎幽门螺旋杆菌
幽门螺旋杆菌四联	幽门螺旋杆菌四联
幽门螺旋杆菌四联	幽门螺旋杆菌四联
眼影画法	眼影画法
完美日记眼影	眼影挑选
眼影推荐	眼影品牌推荐
nars眼影价格	nars眼影价格
眼影价格	不检索
吃麻团的危害	不检索
运动减脂操	不检索
燃脂操	暴汗燃脂运动
运动后变美	运动的好处
减肥的方法	不检索
体育比赛	不检索
跑步的好处	体育比赛有什么
2022北京冬奥会	北京冬奥会
冬奥会闭幕式	不检索
当上雪上运动的志愿者	不检索
北大的校园	北大景点
未名湖	未名湖
阴天的好处	阴天拍照技巧
吉林省延边朝鲜族自治州天气	吉林省延边朝鲜族自治州天气
阴天拍照	不检索
香港疫情	香港疫情
香港疫情	不检索
香港疫情	不检索
香港下一周期	不检索
香港疫情2.24-3.9	不检索
作家	作家
东野圭吾	东野圭吾
东野圭吾	东野圭吾作品
白夜行小说	东野圭吾白夜行
东野圭吾	不检索
2022年的著名赛事	不检索
2022年冬奥会	不检索
2022年冬奥会	卡塔尔世界杯
卡塔尔足球世界杯	不检索
2022年世界杯冠军是哪个队来着	不检索
过年的习俗	过年有哪些习俗
过年的习俗	民间习俗
元宵节的文化遗产	不检索
相机拍照	不检索
过年的习俗	不检索
吃水果的好处	3月份的应季水果
草莓和车厘子	吃草莓的好处
车厘子和樱桃有什么区别么	车厘子和樱桃有什么区别么
车厘子和樱桃有什么区别	不检索
樱桃和草莓的区别	不检索
土猫	不检索
小奶猫	不检索
养猫的注意事项	小猫不能洗澡
养猫的注意事项	不检索
宠物医院检查猫的花销	流浪猫检查身体多少钱
化妆的好处	工作化妆
淡妆的好处	淡妆
淡妆怎么化	不检索
酷的化妆穿搭风格	酷化妆风格
酷的化妆穿搭风格	不检索
新生生活用品	新生开学必备品
校服	不检索
新生开学需要带什么生活用品	生活用品的种类
淘宝购物	不检索
生活用品的种类	生活用品的必须性
床帘的作用	床帘的必要性
冬季护肤	面膜的种类
撕拉型面膜推荐	撕拉型面膜有什么好处
撕拉型面膜	化妆品的危害
清洁面膜的方法	面膜一般使用几次
清洁面膜的方法	附近的商场
沈阳商场	不检索
天堂雨伞	天堂牌
雨伞品牌	雨伞品牌推荐
国外雨伞品牌	国外雨伞品牌
国外雨伞品牌	雨伞挑选攻略
雨伞品牌	不检索
单亲家庭的孩子	不检索
单亲家庭的孩子	不检索
单亲家庭的孩子	不检索
昆明的气候	昆明气候
婆媳关系怎么处理	怎么处理婆媳关系
妈妈控制欲强怎么办	妈妈控制欲强怎么办
李泽楷	著名歌手
周深	周深
周深电视剧	周深
周深	周深
周深	不检索
一句顶一万句	一句顶一万句
刘震云	刘震云
一句顶一万句电影	不检索
一句顶一万句电影	一句顶一万句电影
一句顶一万句电影	不检索
《士兵突击》	不检索
许三多	不检索
《士兵突击》的作者。	《士兵突击》的作者。
兰晓龙	兰晓龙。
我的团长我的团	不检索
红烧肉	红烧肉味道
红烧肉的营养价值	红烧肉好处
红烧肉酸辣土豆丝	红烧肉拌饭
红烧肉做法	红烧牛肉做法
红烧牛肉	不检索
红烧肉的做法	不检索
傣族人吃辣	傣族人吃辣吗
傣族人不吃辣	不检索
云南美食	傣族美食
包烧	包烧
包烧	不检索
韩剧《那年我们》	金多美
韩剧《那年我们》的cp粉	不检索
国产剧	国产剧爱情剧
一闪一闪亮星星主演	一闪一闪亮星星电影
张佳宁如懿传	张佳宁如懿传
和男朋友吵架了怎么办	和男朋友吵架了怎么办
和男朋友吵架了怎么办	吵架怎么冷静
哄男朋友的方法	不检索
谈恋爱的技巧	谈恋爱小技巧
谈恋爱的技巧	不检索
钓鱼的好处	不检索
钓鱼的好处	钓鱼得好处
钓鱼时间	不检索
钓鱼的好处	不检索
西丽山湖钓鱼场	西丽山湖钓鱼场
西丽山湖钓鱼场	不检索
臭味食品	臭味食品
螺蛳粉	螺蛳粉丑
臭鸡蛋	不检索
鲱鱼罐头怎么吃	不检索
鲱鱼罐头三明治	不检索
搜索引擎检索搜索引擎	不检索
搜索引擎和大数据的关系	搜索引擎的联想涉及大数据吗
搜索引擎的关注点	搜索引擎检索算法
搜索引擎检索算法	不检索
搜索引擎检索算法	不检索
汉密尔顿音乐剧	汉密尔顿音乐剧
汉密尔顿音乐剧	音乐剧汉密尔顿作曲
迪士尼电影海公主	迪士尼音乐
迪士尼动画	不检索
迪士尼动画2021年上映	迪士尼动画2022年上映
卷发怎么护理	不检索
大波浪卷发怎么护理	大波浪卷发怎么护理？
弹力素	弹力素
弹力素	不检索
弹力素一天用一次	弹力素一般几天用一次。
过敏性鼻炎	过敏性鼻炎原因
基因过敏	基因性过敏能根治吗
过敏性鼻炎	不检索
疫情前过敏性鼻炎	不检索
过敏性鼻炎	不检索
图木舒克市天气	新疆维吾尔自治区图木舒克市天气
玩游戏的好处	不检索
王者荣耀	王者荣耀
王者荣耀	不检索
王者荣耀的玩法	不检索
穿搭的技巧	穿搭博主
穿搭	穿搭杂志
穿搭杂志	不检索
小红书穿搭	不检索
小红书穿搭	不检索
作家	作家
吴承恩	吴承恩
鲁迅	鲁迅
鲁迅重要思想宣传	鲁迅重要思想宣传
李大钊	李大钊
流行音乐	不检索
陈奕迅的歌	陈奕迅的歌
陈奕迅的歌	陈奕迅关于人生的歌
陈奕迅的歌	陈奕迅和林夕
林夕演唱会	不检索
陈奕迅的演唱会	不检索
来宾市的历史	来宾市名由来
来宾市历史	来宾市历史
来宾市的历史	不检索
来宾市的发展历史	不检索
来宾市发展的原因	不检索
喜欢猫的原因	不检索
英短	英短
加菲猫和英短的区别	不检索
养猫的注意事项	养猫的方法
宠物医院	不检索
极限挑战	不检索
黄渤	不检索
黄渤	黄渤
黄渤出道	黄渤电影
黄渤	不检索
2021我国航天发射次数居世界第一	2021我国航天发射次数
空间站建设	空间站建设的意义
航天发展史	航天发展史
钱学森航天史	中国航天史的里程碑
神舟五号载人	神舟五号载人
神舟五号的建造	不检索
和星座不合的男生在一起	不检索
星座	不检索
双鱼和狮子的性格	双鱼女和狮子男
双鱼女和狮子男	星座科学
双鱼座和狮子男的性格特点	不检索
星座	如何看星座
农历10月6日	农历10月6日是阳历多少号
10月30日是什么星座	10月30日是什么星座
天蝎座和水瓶座的配对	天蝎座配对
天蝎座和水瓶座的感情	不检索
外国文学	外国文学
欧亨利	列夫托尔斯泰
欧亨利	欧亨利
欧亨利	欧亨利
欧亨利	欧亨利
欧亨利的风格	欧亨利
养宠物的好处	不检索
养宠物的好处	不检索
防止哈士奇拆家	防止哈士奇拆家
哈士奇拆家	不检索
两岁的二哈	不检索
成为一名老师的意义	不检索
语文老师	不检索
教师资格证考试	教师资格证考试流程
教师资格证笔试	教师资格证考试的时间
教师资格证笔试	教师资格证笔试科目
教师资格证笔试	不检索
穿搭的风格	小香风穿搭
小香风穿搭	不检索
香奈儿的包包	香奈儿黑色链条包
香奈儿2万出头的格纹手提包和金	不检索
香奈儿的包包	不检索
邓紫棋	邓紫棋
邓紫棋本名	邓紫棋本名
邓紫棋的歌	邓紫棋的歌
邓紫棋喜欢的颜色	邓紫棋喜欢的颜色
bingo	不检索
priest	不检索
priest	不检索
priest的书	priest作家的书
镇魂	镇魂
priest	不检索
平板电脑	平板电脑的品牌
苹果和安卓的区别	苹果的平板电脑和安卓的平板电脑
ipad的种类	ipad的种类
ipadpro	不检索
苹果和安卓的区别	不检索
养生的好处	养生
黄帝内经	黄帝内经简介
冬天养生	冬天养生
冬天运动	冬天运动
冬天可以做的运动	不检索
香奈儿的历史。	香奈儿品牌历史
香奈儿的历史	不检索
香奈儿是什么时候成立的？	不检索
可可香奈儿	可可香奈儿
香奈儿的特色产品	香奈儿的特色产品
歌手当打之年	歌手当打之年
毛不易	毛不易
毛不易	毛不易歌曲
毛不易	毛不易的性格
毛不易	不检索
毛不易	不检索
周杰伦的歌	不检索
周杰伦的歌	周杰伦的代表作
周杰伦的歌	周杰伦唱歌特点
周杰伦的电影	周杰伦的电影
《头文字d》	《头文字d》主演
养猫的好处	不检索
猫睡觉打鼾	猫咪睡觉打鼾
猫为什么打鼾	不检索
猫咪愿意和你玩	不检索
猫爬架安全吗	猫爬架安全吗
桂圆的营养价值	咳嗽
呛到气管	呛到气管
桂圆产地	疫情桂圆产地
桂圆价格	桂圆均价中国
桂圆的营养价值	不检索
感冒吃桂圆的危害	桂圆咳嗽少吃
高中和大学的区别	不检索
三本	三本
大学和学校的区别	不检索
985和211的学生就业	985
985和211的区别	不检索
大学的就业方向	不检索
成为一名人民教师	航天员
成为一名航天员需要学习什么	不检索
大学教师	大学教师
大学的孩子们很成熟，可以更好的沟通，可以对症下药。	不检索
现在的孩子们的成长环境	大数据时代
教师的正能量	不检索
野山人参的功效	野山人参的功效
人参汤	人参归脾丸月经量少、色淡
人参归脾丸	人参归脾丸材料
人参归脾丸价格	人参价钱
人参价格	人参太贵
人参价格	不检索
跳舞的好处	不检索
民族舞	民族舞
孔雀舞	孔雀舞怎么学
孔雀舞	孔雀舞的特点
民族舞的舞蹈班	不检索
龙游天下电视剧	龙游天下简介
龙游天下国主	龙游天下国主扮演者
龙游天下国主五味	不检索
龙游天下国主珊珊	不检索
龙游天下国主珊珊	不检索
车厘子	不检索
草莓的营养价值	草莓类型
丹东草莓	丹东草莓
丹东草莓	草莓保鲜
草莓坏了怎么办	不检索
难闻的水果	难闻的水果
表面有尖刺的水果	表面有尖刺的水果
榴莲能吃吗	不检索
榴莲的营养价值	榴莲营养价值
榴莲的营养价值	不检索
海岸村恰恰恰	海岸村恰恰恰
申敏儿	不检索
狗焕和德善	不检索
柳俊烈全度妍	不检索
全度妍的电影名	全度妍
宠物猫	不检索
贵的猫	不检索
缅因猫	缅因猫贵
贵的缅因猫	中华田园猫
中华田园猫多少钱	中华田园猫多少钱
福建漳州流浪动物	福建漳州流浪动物
冬天穿毛衣的注意事项	不检索
毛衣的款式	不检索
羊毛的毛衣和羊绒的毛衣	不检索
羊毛和羊绒的区别	羊毛与羊绒的区别
毛衣搭配	毛衣搭配
毛衣搭配	不检索
学做饭的方法	不检索
简单的菜	不检索
蒸鸡蛋羹	蒸鸡蛋羹
蒸鸡蛋羹的步骤	蒸鸡蛋羹
蒸太久会怎样	鸡蛋羹蒸太久后果
糖尿病	糖尿病
糖尿病人年龄	中国老年人患糖尿病人数比例
得糖尿病难受吗	得糖尿病难受吗
预防糖尿病	预防糖尿病
不熬夜的危害	不检索
幽门螺旋杆菌	幽门螺旋杆菌
慢性胃炎幽门螺旋杆菌	慢性胃炎注意事项
戴老花眼镜的危害	不检索
老年人的好处	不检索
老年人锻炼	不检索
芜湖为什么会变为语气词	芜湖为什么会变为语气词
芜湖市为什么会变为语气词	不检索
芜湖市美食	芜湖市美食
无为板鸭	巢湖麻鸭
巢湖麻鸭做法	不检索
明天的蔬菜	不检索
冬季蔬菜	冬季应该买什么蔬菜吃
青菜的营养价值	不检索
超市的蔬菜	超市和菜市场的蔬菜的区别
菜市场的蔬菜	不检索
ipad的价格。	不检索
ipad的好处	不检索
ipad的品牌。	苹果ipad的款式。
ipadpro13.9英寸价格	ipadpro的价格。
ipadpro135gb价格。	不检索
北京航天航空大学	不检索
神舟12号	不检索
学航天的好处	不检索
神舟12号	神舟12号。
中国第一个进入太空的人。	中国第一个进入太空的人。
草莓蛋糕	不检索
草莓蛋糕	草莓甜品
草莓热量	鲜草莓热量
鲜草莓怎么做	草莓做什么
草莓成熟	草莓成熟
古代人的历史	不检索
人类的诞生	不检索
盘古开天辟地	盘古的故事
盘古洞	不检索
桂林的景点	桂林山水
新疆的地形	新疆的地形
阿拉尔市的山	阿拉尔市地域
阿拉尔市景点	阿拉尔市景点
阿拉尔市美食	不检索
阿拉尔市美食	不检索
摄影器材	摄影器材有哪些
变焦镜头	尼康相机
尼康相机	如何自学摄影
摄影网站	不检索
学习摄影的网站	不检索
相声	不检索
德云	德云社相声演员
秦霄贤	秦霄贤的代表作
郭麒麟	不检索
郭麒麟演的电视剧	不检索
杨丽萍的孔雀舞	杨丽萍
孔雀之灵	不检索
杨丽萍跳拉丁舞的原因	孔雀舞
孔雀舞的起源	有孔雀的国家
孔雀舞的起源	不检索
英雄联盟全球总决赛	不检索
英雄联盟冠军	fpx战队
英雄联盟	不检索
永劫无间	永劫无间
消消乐难吗	不检索
巴中天气	四川省巴中市天气
巴中天气	不检索
四大名著	西游记
西游记的内容	西游记
巴中明天天气	不检索
吃零食的危害	附近的超市
零食推荐	零食推荐
吃饼干上火的危害	不上火的零食
酸奶的好处	酸奶推荐
卡士酸奶	不检索
山东莱芜市乒乓球比赛	不检索
打乒乓球的好处	不检索
乒乓球的比赛	中国的乒乓球
乒乓球的比赛	我国乒乓球的运动员
东京奥运会乒乓球比赛	东京奥运会乒乓球女单
伊藤美诚	不检索
双鱼座男女比例	不检索
双鱼座	双鱼座时间
双鱼座	双鱼座适合星座
巨蟹座	不检索
射手座	射手座最配星座
流浪狗	流浪狗
流浪狗为什么被丢弃	不检索
养了宠物又要丢弃它们	丢弃宠物
宠物救助电话	不检索
帮助流浪狗	帮助流浪狗
大学生就业	不检索
考公	2021国考人数
国考报名人数	不检索
国考复习方法	复习国考的技巧
国考题型	不检索
做题的方法	不检索
天文学专业	不检索
天文系	国内有天文系的高校
国内天文系	国内天文系哪个好
南大天文系	不检索
南大	不检索
参观高校	不检索
2022年电影	不检索
漫威电影	漫威电影
漫威电影主角	漫威电影主角
雷神	雷神电影
雷神三部曲	雷神第三部
晚上几点睡	不检索
熬夜的危害	熬夜的危害
睡不着怎么办	睡不着怎么办
白噪音	白噪音
白噪音	哪些声音是白噪声
学游泳的好处	不检索
运动员	运动员
运动员	不检索
苏翊鸣	苏翊鸣
单板滑雪	不检索
养花的好处	不检索
菊花掉了好多	菊花掉了好多
菊花掉了好多	菊花掉了好多
菊花褐斑病	菊花褐斑病怎么办
菊花褐斑病	不检索
李泽楷	范冰冰
范冰冰长相	不检索
周润发	周润发
周润发	不检索
周润发	不检索
汉堡	汉堡
汉堡包	不检索
汉堡是哪个国家发明的	汉堡包是哪个国家发明的
汉堡是哪个国家发明的	不检索
薯条是哪个国家发明的	薯条是哪个国家发明的？
薯条是哪个国家发明的	不检索
天门景点	不检索
天门景点	天门市有什么景点
天门有划区吗	天门市为什么不设区
天门市行政区划	不检索
天门商区	天门商区有哪些
生活用品	生活用品
电动牙刷的好处	电动牙刷的好处和坏处
电动牙刷的好处	电动牙刷的原理
电动牙刷的原理	电动牙刷的牌子
清洁面膜	清洁面膜的推荐
科颜氏白泥净肤面膜	不检索
抖音	抖音
淘宝美食	不检索
抖音	冲动
看帅哥的好处	不检索
看帅哥的好处	昏君
看帅哥的危害	不检索
巴西足球运动员	巴西足球球王
贝利	贝利进过多少球
贝利	进球最多的球员
巴西一共拿过几次世界杯冠军	巴西一共拿过几次世界杯冠军
世界杯冠军什么时候能轮到我们中国	不检索
春晚的春晚	不检索
春晚的小品	春晚的小品演员
赵本山的电视剧	不检索
赵本山的小品演员	不检索
郭冬临和牛莉	郭冬临和牛莉在春晚的小品
咳嗽的原因	流感
嗓子痛	嗓子痛
头疼	头疼
头疼原因	不检索
头疼的原因	不检索
早睡的好处	不检索
晚上睡觉的时候有什么动静	不检索
被偷的东西	不检索
楼道监控	针孔摄像头价格
针孔摄像头装在楼道里	楼道装摄像头构成侵权吗
家委会的责任	不检索
李泽楷。	五月天
iu的歌	iu歌手
iu的歌	iu电视剧
步步惊心：丽	《步步惊心：丽》
步步惊心：丽	不检索
步步惊心电视剧	步步惊心电视剧
三国演义	三国演义算历史吗
《三国志》	三国志白话版
《三国志》的白话版	如何了解三国历史
如何了解三国历史	不检索
当当卖三国书的网站。	不检索
洗发液用过几次头皮难受	不检索
洗发液的作用	洗发液导致头皮瘙痒
洗发水表面活性剂导致瘙痒	洗发水表面活性剂导致瘙痒
洗发水表面活性剂	洗发水表面活性剂什么温和一点
洗发水的成分	不检索
说唱歌手	说唱歌手
图派克	不检索
图派克的作品	图派克的经典作品
图派克的作品	不检索
图派克和他的作品	不检索
小红书电影	小红书
小红书	不检索
美妆博主	不检索
哔哩哔哩	哔哩哔哩
哔哩哔哩电影片段	不检索
《非正式会谈》	《非正式会谈》
工作太忙的原因	不检索
看电影的方法	不检索
詹尼佛劳伦斯	詹尼佛劳伦斯
饥饿游戏	饥饿游戏电影
詹尼佛劳伦斯	詹尼佛劳伦斯
詹尼佛劳伦斯	不检索
产品经理考试	产品经理的考试
产品经理国际资格认证	不检索
营养资格证书	营养资格证书
营养资格证书	不检索
托福	不检索
北大清华最叼的学校	不检索
北京的大学	北京好的大学
中国人民大学	不检索
北京邮电大学	北京邮电大学
北京四中	不检索
长胖的原因	不检索
吃零食的危害	吃零食的危害
吃零食的危害	如何减少吃零食
吃什么水果	不检索
吃零食的危害	不检索
中国足球什么时候能有起色	不检索
中国女足	中国女足夺冠
中国女足	中国女足vs韩国
中国女足的自信心	不检索
中国女足	不检索
mac	不检索
mac口红	mac口红
抚顺市天气	附近商场
苹果mac口红	不检索
明天的天气	明天气温
四大名著	不检索
四大名著	不检索
红楼梦	不检索
三国演义	不检索
西游记	西游记
带孩子的经验	不检索
1岁小孩	1岁小孩
5岁的儿童	5岁的儿童
和孩子交流的方法	不检索
育儿的书	育儿的书
儿童读物	儿童读物
新海诚的电影	新海诚作品
你的名字电影	你的名字电影
2021年上映的电影	不检索
阿克苏天气	阿克苏天气预报
阿克苏天气	不检索
吉林市天气	吉林市今日天气
吉林市天气	不检索
吉林省吉林市天气	今日中国北方有城市下雪了吗
打雪仗	不检索
吉林纬度	不检索
即墨古城	即墨古城
即墨古城	即墨古城夜晚
即墨古城夜晚	即墨
栈桥海鸥	栈桥海鸥
栈桥海鸥	不检索
会计需要看哪些书	会计看哪些书
学会计需要看哪些书	职业会计做什么
会计工资	会计工资
高级会计	高级会计职业
高级会计职业	不检索
高级会计的工资	不检索
养狗的好处	养狗
什么狗狗适合当宠物	不检索
小型犬	适合当宠物的狗
养狗需要准备什么	养狗需要准备什么
狗粮	狗粮推荐
焦作哪里卖狗粮	买狗粮的网站
养猫的好处	宠物猫
养猫的好处	养猫的好处
猫掉毛	养猫的坏处
小动物发情期	猫遇到发情期怎么办
养猫的危害	猫需要做绝育吗？
养猫的好处	不检索
泡脚的好处	泡脚
泡脚的好处	不检索
泡脚的好处	不检索
泡脚的中药	泡脚中药
泡脚中药	泡脚水温
电影推荐	不检索
悬疑推理电影	喜剧电影推荐
皮克斯的动画	皮克斯电影
《寻梦环游记》	不检索
《寻梦环游记》	舒缓悲痛的心情
电脑开不了机	不检索
笔记本充不进电	电脑充不进电是主板问题吗
电脑用三年多了。	不检索
笔记本品牌。	笔记本品牌哪个好
联想笔记本	不检索
化妆品推荐	不检索
化妆的好处	不检索
毛戈平	毛戈平
化妆艺术学校	化妆艺术学校
毛戈平形象设计艺术学校报名	不检索
甲方乙方	甲方乙方
甲方乙方	不检索
冯小刚式幽默	不检索
冯小刚的电影	冯小刚的电影。
非诚勿扰	不检索
早上吃什么饭	不检索
芹菜的好处	芹菜有什么好处
芹菜叶子可以吃嘛	芹菜叶子可以食用嘛
芹菜叶子丢弃太浪费	不检索
芹菜可以做什么菜肴	芹菜菜肴
迪丽热巴	不检索
迪丽热巴	不检索
迪丽热巴和古力娜扎的矛盾	分不清迪丽热巴和古力娜扎
迪丽热巴演的电视剧	迪丽热巴演的电视剧
《你是我的荣耀》	《你是我的荣耀》
攀岩的好处	【攀岩的好处
初学者是不是专业的指导	攀岩初学者是不是专业的指导
攀岩保护绳	不检索
攀岩装备	攀岩需要的装备
攀岩装备	不检索
短道速滑	不检索
短道速滑介绍	短道速滑介绍
中国队	不检索
中国短道速滑	不检索
短道速滑	短道速滑名将
耙耙柑	耙耙柑
橘子脸黄	橘子脸黄
橘子吃多了脸黄	不检索
橘子上火	不检索
上火的原因	不检索
清朝的历史	不检索
清朝一共几个皇帝	清朝一共几个皇帝
清朝第一个皇帝是谁	清朝的第一个皇帝是谁
清朝的贡献	清朝的贡献
关于清朝的电视剧	清朝的电视剧
《步步惊心》违背历史吗？	《步步惊心》违背历史吗
喂饭的年龄	喂饭的年龄
喂饭的坏处	训练儿童自己吃饭
喂饭的坏处	喂饭的坏处
喂饭的危害	不检索
教育小孩的耐心	教育需要耐心
小时候的零食	陕西省渭南小零食
吃辣条的好处	零食都有什么
薯片热量	热量低的零食
吃巧克力的好处	不检索
西安天气	不检索
零食	不检索
黄瓜味薯片	薯片的热量
吃零食的危害	低热量的零食
辣条	辣条痔疮
吃瓜子的危害	不检索
山核桃口味的瓜子	不检索
父母经常吵架会对孩子的成长带来很多问题吗	父母经常吵架会对孩子的成长带来很多问题吗
经常吵架的危害	不检索
离婚率的变化	离婚率的变化
离婚率的影响	不检索
离婚率的变化	不检索
烹饪学校	不检索
菜系	烹饪菜系
粤菜和我们平时做菜方法有什么不一样	粤菜
粤菜烧鹅	粤菜烧鹅
粤菜烧鹅	不检索
草莓价格	草莓品种
草莓糖葫芦	不检索
草莓吃多了会上火吗	草莓吃多了有什么事么
草莓价钱	不检索
河南草莓价格	不检索
银行卡	不检索
银行卡归属地查询	银行卡归属地查询
银行卡归属地查询	银行卡归属地查询
银行卡卡号	银行卡盗刷
银行卡盗刷后银行会赔偿吗	保护银行卡信息重要性
银行卡盗刷怎么办	不检索
酒泉旅游	酒泉景点
鸣沙山	鸣沙山
鸣沙山	鸣沙山地址
酒泉卫星发射基地	甘肃酒泉卫星发射基地
酒泉景点	酒泉旅游时间
吉林省四平市天气	吉林省四平市天气
做菜的菜谱	家常菜菜谱推荐
拿手菜	红烧肉
红烧肉做法	不检索
红烧肉	不检索
小说网站	小说网站
小说网站	小说网站
起点中文网小说	不检索
起点中文网小说	起点中文网言情小说
起点文	不检索
阿拉善旗	阿拉善旗
旗是什么	行政区划“旗”
清朝的八旗	行政区划“旗”
阿拉善旗	内蒙古三盟
阿拉善旗	不检索
快速减肥的运动	快速减肥的运动
跳绳对膝盖的损伤	跳绳伤膝盖吗？
跑步的好处	不检索
游泳伤膝盖吗	不检索
游泳的好处	不检索
粉底液挑选	粉底液挑选
粉底液挑选	粉底液挑选
粉底液挑选	粉底液选择
粉底液选择	不检索
粉底液选择	不检索
广西钦州市天气	不检索
旅行的好处	不检索
广西梧州景点	三亚旅行景点
三亚离海边最近的地方	湛江旅游景区
湛江景点	不检索
无聊的时候玩游戏	不检索
玩游戏的危害	腾讯游戏
王者荣耀	不检索
开麦被小学生喷了	腾讯防沉迷
玩游戏的坏处	不检索
《儒林外史》	《儒林外史》
看名著的方法	阅读名著的方法
读名著的方法	不检索
名著的分类	网络小说的优点
名著的优点	名著的好处
宁夏美食	宁夏美食推荐
枸杞芽	不检索
宁夏美食	甜点
甜点治愈人	不检索
甜点长胖	不检索
粑粑柑	巴中粑粑柑
粑粑柑	粑粑柑
粑粑柑疫情	粑粑柑口味
橘子的味道	橘子和粑粑柑有何不同
橘子为什么坏	橘子为什么坏得快
橘子为什么坏	不检索
甘肃酒泉景点	甘肃省酒泉景点
敦煌莫高窟	敦煌莫高窟
敦煌莫高窟	敦煌莫高窟的主窟
敦煌莫高窟	不检索
甘肃美食	甘肃美食
苏炳添	苏炳添
苏炳添	不检索
苏炳添的努力	中国跑步运动员还有哪些
王军霞	不检索
中国的女性运动员	不检索
养宠物的好处	不检索
北京哪里可以买到猫	不检索
领养流浪猫	宠物领养
流浪猫领养	不检索
买宠物要注意什么	宠物领养
英语考试	不检索
阅读的正确率	英语阅读
略读的方法	略读能力
阅读题的题型	阅读题
阅读题的题型	不检索
高铁的速度	高铁的速度
高铁的乘务员	不检索
高铁上有什么旅客遵守的规定	高铁上有什么旅客遵守的规定
高铁上不能吃泡面	高铁上可以吃泡面
高铁上可以吃泡面	不检索
廊坊房价	廊坊地房价
廊坊房价	不检索
房价什么时候才会跌下来	房价什么时候才会跌下来
房价什么时候才会跌下来	不检索
买房的注意事项	不检索
阳泉的历史	阳泉地名由来
阳泉为什么叫阳泉	阳泉近代历史
阳泉历史	阳泉经济发展为什么落后
阳泉发展的新技术	不检索
阳泉历史书	不检索
阳泉历史书	不检索
找工作的好处	不检索
工资高的工作	工资高的工作
会计的工资	会计的薪酬
高级会计的素质	高级会计需要的素质
高级会计毕业	高级会计的考试资格证
高级会计考试	不检索
冬奥会	不检索
谷爱凌	谷爱凌
冬奥会闭幕式时间	北京冬奥会闭幕式是什么时间
冬奥会直播	不检索
冬奥会闭幕式	不检索
海子诗歌	诗歌中国当代
海子	海子介绍
诗歌欣赏	诗歌欣赏
海子的诗歌	海子诗歌
面朝大海，春暖花开海子	面朝大海，春暖花开海子
中国的乒乓球	不检索
中国的乒乓球运动员	不检索
马龙	乒乓球员马龙
马龙	不检索
中国乒乓球队的独门绝技	中国乒乓球绝技
焦作舞蹈兴趣班	不检索
孩子学舞蹈的好处	女生学舞蹈的好处
学舞蹈的好处	芭蕾舞学习年龄
小茶适合的芭蕾舞	不检索
芭蕾舞的学习方法	不检索
学舞蹈的好处	不检索
盘锦景点	辽宁盘锦的景点
盘锦自然公园	辽宁盘锦的自然公园
盘锦森林公园	不检索
盘锦购物中心	不检索
盘锦景点	不检索
白切鸡	不检索
白切鸡	白切鸡
香港茶餐厅	香港茶餐厅
香港美食	广州早茶
老干妈云吞面	不检索
舞剧推荐	《昭君》舞剧
昭君出塞舞剧	不检索
唐诗逸舞剧	唐诗逸《恰同学少年》舞剧
学舞蹈的年龄	古典舞学习
古典舞的学习方法	不检索
考试前紧张	如何缓解考前紧张
考前拉肚子原因	考前拉肚子
考前紧张	不检索
吃不下饭的原因	紧张吃不下饭怎么办
缓解压力的方法	不检索
手游	不检索
手游	不检索
哈利波特手游	哈利波特魔法觉醒手游
哈利波特手游	不检索
哈利波特魔法学院	不检索
身体乏力的原因	不检索
上班久坐的危害	上班久坐
上班的时间	不检索
办公室久坐舒缓运动	不检索
附近跑步	不检索
人工智能	人工智能的应用
导购机器人	不检索
人工智能取代人类	人工智能取代人类
人工智能的发展水平	人工智能
人工智能的应用	不检索
丁克老人	不检索
养老的必要性	养老需要注意的问题
智商高的狗	智商高的狗
金毛	金毛
金毛	不检索
泰坦尼克号电影	电影泰坦尼克号
泰坦尼克号电影	泰坦尼克号电影
李奥纳多迪卡普里奥	不检索
泰坦尼克号	不检索
泰坦尼克号主题曲	我心永恒
空气炸锅	不检索
空气炸锅	空气炸锅是干什么的
空气炸锅	空气炸锅品牌
空气炸锅	不检索
披萨	披萨的种类
薄脆披萨	不检索
钓鱼的好处	不检索
钓鱼装备	钓鱼的装备
钓鱼的装备	钓鱼准备
周末天气	吐鲁番周末天气
钓鱼的注意事项	不检索
耽美小说	不检索
学霸男主	学霸男主
c9大学	c9大学有哪些
小说he	小说的he和be
be小说	不检索
电音	电音是什么
电音	电音是使用合成器的音乐吗
电音理论	不检索
电音学什么	不检索
音乐创作的经济基础	不检索
纸巾的品牌。	不检索
纸巾品牌	纸巾品种品牌
湿纸巾	湿纸巾
纸巾品牌	不检索
买纸巾的钱	支付途径
觉醒年代	觉醒年代
觉醒年代	觉醒年代
觉醒年代	觉醒年代
中国共产党	中国共产党
觉醒年代	觉醒年代
李大钊、陈独秀	不检索
郊县天气	郊县天气
爬山	爬山
爬山的好处	郊县附近的山
爬山的工具	不检索
爬山的工具	爬山装备
爬山的好处	不检索
古装剧辣眼睛	辣眼睛的古装剧
电视剧《凤求凰》	不检索
张卫健	张卫健的古装剧
张卫健	不检索
陈晓	不检索
3ce眼影盘	3ce眼影盘
眼影推荐	眼影推荐
日韩眼影推荐	日本眼影推荐
卸眼妆	卸眼妆
眼唇涂什么油	不检索
微博摄影	不检索
拍照的技巧	不检索
拍照的技巧	拍照的技巧
摄影的影子	不检索
景观设计	不检索
如何拍出好看的照片	《布达佩斯大饭店》
天蝎座	不检索
双鱼座性格	双鱼座性格
双鱼座和什么星座的人最相配	不检索
天蝎座	天蝎运势
天蝎座运势	天蝎运势
手机摄影的优点	照片评论
手机摄影的优点	手机摄影优点
拍照软件	手机软件p图
手机拍照软件	手机拍照教程
手机拍照的方法	不检索
王蒙	运动员王蒙
王蒙	王蒙有多厉害
王蒙的性格	王蒙有多逗
王蒙在冬奥会的采访。	不检索
王蒙	不检索
做饭的好处	不检索
怎么学做饭	不检索
b站美食up主	不检索
史上最棒炸鸡	不检索
焦作美食up主	美食up主
女儿国	不检索
86版西游记女儿国国王	86版西游记女儿国
唐僧的责任	唐僧取经的责任
唐僧原型	唐僧原型
唐僧的伟大	不检索
语文成绩不及格	语文成绩
语文跑题	作文跑题
作文跑题	不检索
语文落下了怎么办	落下了课程
语文老师	不检索
刘翔	刘翔奥运会
刘翔退役	刘翔退役
2008年奥运会刘翔因伤退役	欠刘翔一个道歉
刘翔心胸豁达	刘翔，心胸豁达
中国的男同胞	不检索
养宠物的好处	不检索
猫的品种	猫的品种
英短	狗的品种
狗和猫的区别	不检索
猫和狗的区别	不检索
孩子的父母	不检索
丁克	丁克
人生的第一次是什么	不检索
丁克	不检索
生男生女的区别	全职妈妈
3月14日出生的是什么星座	3月14日出生的是什么星座
3月14日出生的星座	不检索
双鱼座性格特征	双鱼座性格特征
双鱼座的性格特征	星座科学吗
双鱼座适合和哪个星座在一起	双鱼座和哪个星座相配
海南	海南
定安县	不检索
定安县	海南气候
海南旅游	海南特产
定安县	海南省定安县
定安县气候	不检索
德州市景点	德州市
德州扑克	德州扑克
德州市景点	德州市景点
德州枣	德州市枣
德州市美食	德州美食
托福考试	托福考试
托福考试难吗	托福考试难吗
托福考试怎么准备	怎么准备托福考试？
托福报名	不检索
托福报名	不检索
语文背什么	不检索
语文考试	语文考试背诵
语文学习的方法	不检索
专注app	专注app
专注app	不检索
pummelparty	pummelparty
拳击派对	拳击派对
拳击派对多少人玩	拳击派对
拳击派对多少钱	拳击派对多少钱
拳击派对价格	不检索
联名限量鞋子	耐克联名限量鞋
耐克dunk	耐克dunk
陈伟霆的冰激凌	不检索
耐克限量款	不检索
耐克限量款	不检索
育儿的想法	育儿方面的想法
和孩子一起做事情	不检索
如何和小孩子相处	如何和小孩子相处
和小孩子相处的方法	不检索
丧偶式育儿	不检索
花样滑冰	花样滑冰
花样滑冰	花样滑冰规则
花样滑冰规则	不检索
花样滑冰短节目	花样滑冰规则
花样滑冰规则	花样滑冰规则
花样滑冰评分	花样滑冰评分
中国收视率最高的电视节目	不检索
新闻联播	新闻联播介绍
新闻联播	新闻联播的前身
新闻联播	新闻联播介绍
新闻联播	新闻联播第一位主持人
元宇宙	元宇宙
元宇宙	元宇宙
元宇宙	不检索
元宇宙	不检索
元宇宙的发展水平	元宇宙发展水平
雅思考试时间	毕业打算
出国留学的准备	出国留学的准备
出国留学的注意事项	出国语言考试
雅思	雅思
雅思考试内容	雅思考试内容
雅思考试内容	雅思分数
雅思考试内容	雅思参考书
和男朋友去旅行	不检索
和男朋友旅行	和男朋友旅行
和男朋友旅行的注意事项	不检索
雅鲁藏布江	五一假期去哪里旅游
西安	不检索
公共艺术专业	公共艺术专业学什么
公共艺术专业学什么	公共艺术专业和雕塑关系大吗
公共艺术就业方向	公共艺术就业如何
公共艺术就业方向	不检索
公共艺术的就业方向	不检索
舌头痛的原因	舌头痛的原因
舌头痛的原因	舌头痛怎么办
吃什么东西可以补充维生素	补充维生素的食物
补充维生素的食物	不检索
舌头痛的原因	不检索
电视剧推荐	不检索
肖战	肖战的电视剧
斗罗大陆	不检索
斗罗大陆肖战	不检索
斗罗大陆演员	斗罗大陆演员表
宠物狗	宠物狗
金毛贵吗	金毛的价格
养狗的花销	不检索
金毛陪伴	不检索
香港领养金毛	不检索
时光音乐会	不检索
时光音乐会	时光音乐会
时光音乐会	不检索
时光音乐会	时光音乐会，芒果台。
湖南卫视	不检索
诗歌朗诵大会	不检索
朗诵的诗歌	不检索
李白	李白
蜀道难	蜀道难
诗歌朗诵的方法	不检索
佛跳墙	佛跳墙
佛跳墙材料	佛跳墙
佛跳墙	不检索
佛跳墙做法	不检索
泰州佛跳墙	不检索
小奶狗	小奶狗怎么养
第一次养狗需要注意的事情	不检索
比熊犬	比熊犬
比熊犬	养狗的快乐
小白	狗为什么这么忠诚
养狗的攻略	不检索
香港赛马	不检索
nba篮球赛	不检索
最近的篮球赛	2022年有什么篮球赛赛事
世界大学生运动会	不检索
上半年的球赛	今年上半年的球赛
养花的好处	不检索
养花的好处	不检索
仙人掌的品种	仙人掌的品种
子孙球是什么	仙人掌子孙球
好看的仙人掌	好看的仙人掌
仙人掌的品种	不检索
胖人穿搭	不检索
穿什么衣服会显瘦	穿什么衣服容易显瘦
夏天穿黑衣服的好处	为什么夏天穿黑衣服会热
穿什么颜色的衣服都胖	不检索
减肥的方法	不检索
许昌市玫瑰	不检索
许昌市玫瑰	不检索
玫瑰和月季有什么区别	玫瑰和月季有什么区别
玫瑰的品种	玫瑰的品种多么
月季的好处	不检索
驻马店市景点	不检索
驻马店市美食	驻马店市美食街
驻马店美食	驻马店美食
羊肉烩面	驻马店温州步行街羊肉烩面
驻马店美食	不检索
新生代男演员	新生代男演员
易烊千玺电影	易烊千玺电影
易烊千玺跳舞	易烊千玺舞蹈
韩庚	《这就是街舞》导师
《这就是街舞》第四季	不检索
教师资格证笔试	教师资格证考试
普通话考试成绩	普通话考试合格分数
教师资格证考试	教师资格证考试
教资面试	教资面试
教师资格证面试	不检索
十年一品温如言	十年一品温如言是什么时候上映的
十年一品温如言评分	不检索
十年一品温如言主演	十年一品温如言的电影
十年一品温如言	不检索
十年一品温如言	不检索
手机自动关机	手机自动关机
手机自动关机	华为mate40
mate40屏幕	华为mate40屏幕
华为mate40价格	mate40如何买
二手手机电池	不检索
吉林省白山市天气	吉林省白山市景点
东北第二高峰	东北第二高峰
爬山	爬山
爬山热身运动	爬山热身运动
爬山的运动服	不检索
人工智能	人工智能
自然语言处理	自然语言处理
人工智能和自然语言处理有什么关系	人工智能
人工智能	不检索
人工智能	不检索
三体小说	三体小说
三体作者	三体作者
三体主人公	三体主人公
三体小说	不检索
三体女主人公	不检索
国庆假期安排	不检索
国庆旅游	不检索
布达拉宫	布达拉宫
身体不好的人去拉萨	不检索
高原反应	高原反应
嘉兴景点	上海有哪些好玩的
上海迪士尼	上海迪士尼有哪些好玩的
上海迪士尼票价	上海迪士尼的票价是多少
上海迪士尼门票	不检索
努力工作的意义	不检索
莫言	中国著名作家
沈从文	沈从文作品
边城小说	边城简介
边城女主人公	边城女主人公
傩送	不检索
甄嬛传演员	甄嬛传演员
蒋欣	蒋欣
毛晓彤	毛晓彤
天龙八部版本	毛晓彤
2013版天龙八部演员	2013版天龙八部演员
25岁没谈过恋爱	不检索
25岁没谈过恋爱	不检索
谈恋爱的好处	恋爱
找不到合适的异性	不检索
怎么找男朋友	不检索
找男朋友的注意事项	不检索
人大附中	人大附中
人大附中	人大附中
人大附中	人大附中
人大附中	人大附中
人大附中	人大附中评价
认识的女票是什么时候认识的	不检索
武大女生宿舍	不检索
怎么找女朋友	如何找女朋友
白富美	白富美
武汉的景点	不检索
悬疑小说	悬疑书
南派三叔	南派三叔盗墓笔记
《盗墓笔记》的小说	《鬼吹灯》
盗墓小说	盗墓真假
盗墓书籍	墓葬相关书籍
找男朋友的方法	不检索
找男朋友的注意事项	不检索
魔羯座和什么星座比较配	魔羯座和什么星座般配
年龄焦虑	怎么缓解年龄焦虑
散步的好处	不检索
喜欢的男孩子	不检索
打网球的好处	打网球的好处
网球课程	不检索
网球怎么练习	网球怎么练习
网球场价格	重庆网球场地
网球场	不检索
网球场费用	不检索
忘记复习的原因	考试前忘记复习的内容怎么办
背重点的方法	复习考试的诀窍
考试前做什么	考试前吃什么
考试前吃什么	不检索
考试前吃什么	不检索
快乐大本营	好看的电视节目
湖南卫视	湖南卫视的特色
快乐大本营	快乐大本营
何炅	何炅
快乐大本营周日播出时间	快乐大本营停播
跳绳的好处	跳绳的好处
跳绳的好处	不检索
坚持跳绳的好处	运动坚持的意义
跳绳的好处	不检索
坚持运动的好处	不检索
养花的好处	不检索
红玫瑰	适合北方家养的花
红玫瑰	不检索
除了芍药还有什么花是既好看又好养的	长寿花
长寿花	长寿花
长寿花	不检索
长寿花	不检索
梁静茹的歌	不检索
梁静茹	梁静茹代表作
梁静茹的歌	梁静茹《情歌》
梁静茹的故事	不检索
谁的青春没有一个没有陪你走到最后的人	不检索
中国银行	中国银行
中国储蓄银行怎么样	中国储蓄银行
中国银行	不检索
银行的知识	不检索
银行的发展	不检索
日语学习	不检索
看动漫的好处	不检索
日语水平考试	日语水平考试
jtest和jlpt考试哪个比较简单	不检索
jtest考试	jtest考试
冬天的泡面	不检索
早上吃泡面的好处	不检索
宿舍零食	泡面
泡面的种类	不检索
上火吃辣	不检索
彪马	彪马
彪马厚底鞋	彪马厚底鞋
彪马的薄底鞋	不检索
双十一买什么鞋	双十一
双十一多少钱	不检索
今天的天气	明天天气怎么样
带伞的注意事项	附近哪里有卖伞的
唯品会价格	不检索
附近的商场	不检索
珍珠奶茶	不检索
玩游戏的好处	不检索
《恋与制作人》	乙女游戏
乙女游戏	乙女游戏定义
乙女游戏	乙女游戏
乙女游戏	不检索
耽美小说	耽美
耽美小说	不检索
最近书荒的小说	好看的耽美小说
一拜天地小说	一拜天地小说剧情
一拜天地小说	不检索
过年吃饺子的习俗	过年吃饺子的习俗
茴香馅的饺子	茴香馅的饺子
茴香和回音	饺子馅的类型
饺子的由来	饺子的由来
张仲景	张仲景为什么做饺子
饺子的由来	不检索
西安小寨饼干	不检索
好吃的饼干	好吃的饼干
西安哪里有卖三立白巧克力夹心薄脆饼干	不检索
巧克力品牌	好吃的巧克力
西安的超市	不检索
武打明星	武打明星
李连杰	李连杰
李连杰加入新加坡籍	李连杰什么时候加入的新加坡籍
李连杰新加坡籍	不检索
李连杰	不检索
计算机组成原理	计算机组成原理
计算机专业修电脑	计算机专业修电脑
计算机专业能力	计算机专业能力
计算机专业就业方向	计算机专业就业方向
计算机专业工资	计算机专业工资
计算机专业就业方向	不检索
天蝎座	不检索
天蝎座	天蝎座
天蝎座	天秤座性格
天蝎座性格	天蝎座性格
天蝎座的人很神秘吗	天蝎座和什么星座最配
巨蟹座	不检索
紫苏	紫苏
紫苏	紫苏的长相
紫苏作用	紫苏作用
紫苏的味道	紫苏的味道
紫苏烧菜	紫苏可以放在菜里吗？
紫苏煎饼	不检索
绿萝枯黄	绿萝枯黄的原因
绿萝枯黄	绿萝枯黄的原因
绿萝长得好	广西贺州天气
绿萝枯黄怎么办	绿萝发黄怎么办
绿萝枯黄怎么办	不检索
台州天气	台州气候湿度
台州天气	不检索
速食薯片	空气太潮怎么办
家里有空调的好处	不检索
台州气候	空气潮湿的好处
乒乓球练习	乒乓球技巧
张继科	张继科
张继科	不检索
樊振东	不检索
三亚体育馆	三亚体育馆
三亚体育馆	不检索
红楼梦	红楼梦
红楼梦	红楼梦介绍
红楼梦的时间是多少	红楼梦介绍
红楼梦的故事内容	红楼梦故事简介
贾宝玉和林黛玉的故事	红楼梦介绍
古装剧	古装剧
甄嬛传	甄嬛传评价
甄嬛传	不检索
长安十二时辰电视剧	长安十二时辰电视剧
长安十二时辰电视剧	不检索
蒸汽波音乐	蒸汽波音乐
蒸汽波音乐	蒸汽波音乐
蒸汽波音乐	哪些歌是蒸汽波音乐
蒸汽波音乐是哪个国家的？	不检索
cuco的歌	歌手cuco
cuco的歌	不检索
星座	星座
星座	星座
星座的含义	星座
星座的含义	星座天文
十二星座	星座天文
粉底液推荐	粉底液选择
油皮和干皮的粉底液	不检索
粉底液推荐	不检索
粉底液色号	不检索
粉底液色号	不检索
冬奥会	不检索
谷爱凌	谷爱凌
谷爱凌	全能谷爱凌
谷爱凌	不检索
谷爱凌要进军演艺圈吗	不检索
周杰伦演唱会	不检索
演唱会门票	演唱会门票
周杰伦稻香	不检索
演唱会门票	演唱会抢票
周杰伦演唱会	不检索
林夕演唱会	2022年张杰演唱会
张杰演唱会	2022年李荣浩演唱会
北京演唱会	不检索
许嵩薛之谦	不检索
毛不易	不检索
冬天穿搭	不检索
冬天毛衣搭配	冬天毛衣穿搭技巧
毛衣怎么搭配	不检索
铁岭天气	铁岭的气温
铁岭天气	不检索
杨紫	杨紫
杨紫的电视剧	杨紫电视剧
欢乐颂演员	欢乐颂
欢乐四美	欢乐四美
欢乐颂演员表	不检索
头疼原因	头疼原因
头疼原因	头疼如何缓解
头疼药物	头疼药物
头疼药	不检索
熬夜的危害	不检索
头疼原因	不检索
旅行的意义	不检索
大西北	大西北旅行
大西北的景色	大西北的景点
大西北交通	大西北旅行适合什么交通方式
自驾游的好处	不检索
澳网纳达尔	2022澳网决赛纳达尔
纳达尔	不检索
法网	2022年法网日期
德约	不检索
德约	不检索
大数据时代的秘密	不检索
大数据时代的应用	国家反炸app
国家反诈app	不检索
抖音和小红书的算法	不检索
大数据时代的应用	不检索
大数据时代的思维方式	扩展思维的书
车子的保险	车子需要的保险
保险公司	保险公司
太平洋保险	保险公司有几家
人保和平安财险的区别	保险公司哪一家强
创业的公司	开公司的要求
人脉	不检索
摄影的光圈	摄影三要素
摄影教程	摄影教程纽约摄影学院
纽约摄影学院摄影教程	不检索
纽约摄影学院摄影教程	纽约摄影学院摄影教程
光圈是什么	光圈是
生命在于运动	不检索
运动的好处	不检索
广场舞	广场舞
附近广场	附近广场
广场舞6点钟可以跳吗	不检索
李佳琪直播间泡脚桶	不检索
泡脚药包	中药泡脚
养生的好处	不检索
枸杞的好处	枸杞水
养生的好处	不检索
陈奕迅的歌	不检索
陈奕迅十年	陈奕迅十年
陈奕迅的十年	陈奕迅歌曲
陈奕迅的歌	不检索
陈奕迅	不检索
陈奕迅的粤语歌	不检索
羽生结弦	羽生结弦
羽生结弦	不检索
羽生结弦	冰上的尤里
冰上的尤里动画	冰上的尤里多少集
冰上的尤里12集	不检索
德阳市天气	德阳
德阳市美食	德阳市
德阳市美食	德阳市景点
黄继光	黄继光
黄继光	不检索
字节跳动	字节跳动建设“全球创作与交流平台”为愿景
字节跳动的学姐	字节跳动人工智能
字节跳动人工智能	向学姐学习
985院校	985院校的好处
字节跳动双非	字节跳动双非
字节跳动软件	不检索
眼影推荐	四色眼影推荐
新手画眼线	新手画眼线
粉底液推荐	粉底液推荐
ysl口红	ysl口红
ysl口红n416	不检索
家里有味道的植物	什么植物能除味呢
吊兰的作用	吊兰的作用
吊兰好养吗	吊兰好养吗
养花的好处	不检索
家里养的花	不检索
民国历史书	孙中山
辛亥革命	辛亥革命
袁世凯复辟	袁世凯复辟
孙中山失败的原因	不检索
孙中山的军权	不检索
诗歌	诗歌
诗歌的美	不检索
徐志摩再别康桥	再别康桥
康桥是英国的吗？	不检索
徐志摩的《再别康桥》	不检索
林徽因的诗	林徽因
吃外卖的好处	不检索
甘肃特色菜	甘肃特色菜
甘肃特色菜	甘肃特色菜
吃肉的方法	不检索
怎么做狮子头	不检索
摄影的好处	怎么开始学摄影
相机的种类	初学摄影的人适合什么相机
索尼相机	索尼相机好么
索尼相机	不检索
相机和镜头的价格	不检索
马拉松	马拉松
跑步的好处	长跑的优点
长跑的好处	不检索
考试不及格怎么办	考试不及格怎么办
考试不及格怎么办	不检索
律师	律师
律师分类	不检索
成为一名律师的门槛	不检索
当一名律师	知名政法大学
华东政法大学	不检索
三体	《三体》
抬头看星空	不检索
三体	不检索
罗辑	三体罗辑
三体罗辑	猜疑链
刘慈欣	刘慈欣
吃什么水果	不检索
吃桃子的好处	不检索
便宜的水果	买水果便宜的网购平台
橙子和桃汁的区别	不检索
文昌市的水果店	海南文昌市的奶茶店
去哪里旅行	日本有哪些好玩的
银座	银座
买东西的方法	不检索
东京银座价格	不检索
东京塔	不检索
恋与制作人	恋与制作人游戏
恋与制作人男主	不检索
周棋洛	周棋洛
周棋洛	李泽言
李泽言	不检索
肥胖的危害	肥胖会引起什么疾病
减肥的方法	不检索
微胖的人减肥的好方法	微胖的人如何减肥
微胖的人减肥的方法	不检索
羽毛球燃脂吗	打羽毛球燃脂吗
欧美音乐歌单	不检索
华语流行歌手	华语流行歌手
周杰伦	周杰伦的经典音乐作品
《蒲公英的约定》百听不厌	不检索
张杰	张杰音乐作品
宝鸡天气	快销服装品牌
宝鸡开元商城	宝鸡开元商城
宝鸡天气	宝鸡周天天气预报
宝鸡天气	不检索
李宁运动鞋	李宁运动鞋明星款
武侠作品	武侠作家
金庸小说	不检索
金庸武侠作家	不检索
四大名捕	四大名捕
四大名捕	不检索
买房的好处	买房理财刚需
工程抵押房的价格。	工程抵押房
工程抵押房如果房产商破产了，就有可能房子	工程抵押房风险
工程抵押房如何解决产生纠纷	不检索
买房的注意事项	不检索
街舞	不检索
街舞分类	街舞分类
街舞适合男生跳吗	不检索
街舞难学吗？	街舞门槛
街舞学习	不检索
考砸的原因	不检索
北京四中	北京四中学生成绩
北京四中老师	北京补课胜地
补课的好处	不检索
补课的好处	不检索
四川眉山美食	四川美食
廖记棒棒鸡	廖记棒棒鸡
廖记棒棒鸡店	四川眉山廖记棒棒鸡店
廖记棒棒鸡	廖记棒棒鸡店
廖记棒棒鸡	不检索
秦始皇	秦始皇的贡献
秦始皇万里长城	秦始皇万里长城
长城是秦始皇建造的万里长城吗	秦始皇长城
兵马俑	兵马俑
秦始皇的暴君	秦始皇是暴君还是仁君
焚书坑儒是怎么回事	不检索
梁博演唱会	梁博
梁博湖南台综艺	梁博湖南台
《我是唱作人》	我是唱作人
热狗	热狗台湾
中国有嘻哈	中国有嘻哈
中国有嘻哈	不检索
首饰的品牌	不检索
临夏回族自治州哪里可以买到首饰	首饰的品牌
平价的首饰	不检索
淘宝首饰	可以买小众首饰的软件
小众首饰	不检索
烟台水果	烟台市水果
香蕉的好处	香蕉的好处
香蕉能防高血压吗	香蕉的好处
香蕉的功效	不检索
生香蕉和熟香蕉的区别	不检索
三胎政策	三胎政策
独生子女有哥哥姐姐吗	不检索
独生子女领养	独生子女津贴
独生子女津贴	独生子女津贴
独生子女津贴	不检索
教师资格证考试	教师资格证笔试科目
教师资格证考试时间	教师资格证笔试该如何准备
教师资格证面试	教师资格证面试日期
教师资格证笔试时间	不检索
教师资格证考试时间	不检索
行政管理专业	行政管理专业
行政管理专业学什么	行政管理课程
行政管理专业学什么	行政管理学姐
行政管理转专业	行政管理转专业
行政管理专业的就业方向	人的发展取决于
行政管理专业课程	不检索
湖南景点	张家界
爬山的好处	凤凰古镇
凤凰古镇	长沙小吃
长沙小吃	湖南美食
巴陵全鱼宴	不检索
马来西亚旅游	马来西亚旅游
马来西亚气候	马来西亚气候
马来西亚机票	马来西亚疫情
马来西亚疫情	海南气候
海南美食	海南美食
双子座的特点	双子座
双子座	不检索
双子座	双子座今日运势
双子座和什么星座最配	双子座速配
天秤座性格	天秤座性格
减肥吃零食的危害	不检索
不会胖人的零食	好吃不胖的零食。
海苔	好吃海苔的品牌。
波力海苔	不检索
波力海苔	不检索
蜡笔小新	不检索
眉笔	不检索
眉笔选择	不检索
眉笔选择	不检索
植村秀砍刀眉笔	不检索
养猫的品种	不检索
新手养猫	新手适合养的猫
橘猫的性格	橘猫的性格
布偶猫的特点	布偶猫的特点
养猫的食物	猫绝对不能吃的东西
婆媳矛盾	不检索
婆媳矛盾	婆媳矛盾
婆媳矛盾	不检索
科学育儿	科学育儿
科学育儿	不检索
喉咙上火喝菊花茶	喉咙上火喝茶
金银花茶	不检索
容易上火的食物	上火吃什么食物
上火吃什么	不检索
上火吃什么	不检索
公务员考试	公务员考试
公务员考试人数	参加公务员考试人数多么
公务员考试难吗	不检索
公务员考试	公务员考试年龄限制
公务员考试年龄限制	不检索
银行的收入	不检索
银行的工资	不检索
英国研究生	不检索
国内研究生好考吗	研究生考试报名人数
雅思	雅思
本溪市酒店	辽宁省本溪市酒店推荐
本溪市景点	本溪市好玩的景点
本溪市特色美食	本溪市特色美食
长宽猪蹄	长宽猪蹄
本溪市美食	不检索
路遥	路遥
平凡的世界	平凡的世界
平凡的世界	平凡的世界的影响
路遥的平凡的世界	路遥写平凡的世界的动机
路遥	不检索
平原上的摩西	平原上的摩西
东野圭吾	东野圭吾
东野圭吾	不检索
平原上的摩西电影	不检索
平原上的摩西刘昊然	不检索
云南旅行攻略	不检索
云南旅行	云南白族自治州旅游
天龙八部影视城	不检索
段正淳正妻刀白凤	不检索
摆夷族	摆夷族
大理白族自治州	不检索
养宠物的好处	小型宠物有哪些
小型宠物	不检索
蜜袋	如何养蜜袋
夜晚的宠物	不检索
老人养的宠物	不检索
什么职业好	不检索
英语专业	不检索
翻译	翻译
教师资格证报名时间	教师资格证报名时间
教师资格证报名时间	不检索
养龟的好处	不检索
巴西龟	巴西龟
巴西龟吃东西被咬伤	被巴西龟咬伤
养巴西龟的好处	不检索
绿毛龟	绿毛龟
潮牌	潮牌
潮牌	不检索
潮牌	附近商场
拉夏贝尔	拉夏贝尔
拉夏贝尔	不检索
一次性纸杯	不检索
一次性纸杯能耐高温吗	一次性纸杯内膜材料
一次性纸杯品牌	一次性纸杯倒热水有毒吗
一次性纸杯倒水被烫	不检索
一次性纸杯倒水被烫伤	不检索
大学里生活比高中轻松很多。	不检索
大学的月卡期中期末	不检索
大学生活	不检索
社团活动	不检索
大学里的社团活动	不检索
minecraft	不检索
minecraft挖矿	不检索
minecraft挖矿	minecraft镐
minecraft怎么挖矿	minecraft如何合成镐
花里胡哨的镐	黑曜石怎么挖
钻石镐	不检索
火影忍者	最新动漫
经典的动漫	经典日本动漫
火影	不检索
鸣人	不检索
鸣人	不检索
我国第一个登上太空的人	我国第一个我国第一个登上太空的人
杨利伟	不检索
北京航天航空大学分数线	去年北京航天航空大学的录取分数线去年北京航天航空大学的录取分数线
北京航天航空大学分数线	不检索
北京航天航空大学	不检索
汤臣一品的演员	不检索
张晚意	张晚意觉醒年代
张晚意古装剧	张晚意古装作品
风起霓裳	乔家的儿女张晚意
乔家的儿女	不检索
平顶山	平顶山
平顶山	平顶山景点
平顶山中原大佛	平顶山中原大佛
画眉谷	画眉谷
画眉谷	画眉谷
火影忍者的成长	火影忍者励志
鸣人	不检索
死亡笔记	死亡笔记主角
夜神月的父亲	不检索
鸣人的觉醒	不检索
名著的好处	中外名著
中国的名著	中国名著风格
西游记、三国演义、水浒传和红楼梦	不检索
红楼梦的爱情故事	红楼梦
红楼梦的内容	红楼梦的意义
移动硬盘的应用	不检索
移动硬盘的品牌。	现在移动硬盘最大容量
移动硬盘品牌。	移动硬盘什么品牌
索尼移动硬盘	不检索
索尼移动硬盘	不检索
开学时间	不检索
情人节是什么时候开学的	不检索
情人节	不检索
情人节活动	情人节活动
情人节活动	不检索
moody美瞳	moody牌美瞳
moody年抛美瞳	不检索
moody美瞳	moody美瞳种类
moody美瞳活动	不检索
moody美瞳价格	不检索
四级考试	不检索
四级考试	不检索
四级怎么学	四级考试
作文模板	作文模板
作文模板	不检索
北航	不检索
北航的女学生	北航
北航	不检索
北航	北航哪个专业最厉害
软件工程专业	不检索
最近火的动漫	鬼灭之刃
鬼灭之刃	鬼灭之刃
鬼灭之刃	鬼灭之刃
鬼灭之刃	进击的巨人作者
进击的巨人	进击的巨人剧情
佳木斯市天气	黑龙江省佳木斯市天气
佳木斯市天气	不检索
跑步的好处	不检索
刘翔	刘翔
刘翔最大成就	刘翔最大成就
刘翔	不检索
区块链最近行情	区块链最近的行情
区块链技术	如何理解区块链
区块链的风险	区块链技术的应用
区块链最近的行情	不检索
欠了钱怎么办	不检索
辽宁省大连市天气	天气
许嵩	不检索
许嵩	许嵩代表作
许嵩昨夜书	许嵩昨夜书评价
许嵩的歌	不检索
毕业就业	不检索
考编的人数	不检索
体制	体制有什么
公务员考试每年考几次	公务员考试每年考几次
公务员考试每年报名几次	不检索
玩游戏的好处	不检索
单机小游戏	单机小游戏
昭和杂货店物语	昭和杂货店物语
昭和杂货店物语	不检索
消消乐	不检索
金桔的营养价值	金桔过年
金桔的历史	金桔
金桔的营养价值	金桔
金桔的营养价值	金桔价钱
金桔价格	不检索
福建龙岩景点	不检索
过年广州	广州天气
广州美食	广州美食
过年机票	订票软件
广州景点	不检索
火影忍者	不检索
火影忍者	火影忍者
鸣人和佐助的友情	友情的重要性
日本动漫	日漫
杀生丸	不检索
宝宝吃手指的原因	宝宝吃手指的原因
宝宝缺锌的原因	宝宝缺锌吃手指
宝宝缺锌的原因	宝宝缺锌的危害
宝宝补锌的食物	宝宝补锌的食物
吃豆制品的好处	不检索
摄影的好处	不检索
拍电影的技巧	不检索
摄影的类型	摄影的类型
摄影的类型	不检索
佳木斯市的摄影展	最近的摄影展
月季好养吗？	月季好养吗？
养月季需要注意什么	养月季需要注意什么
月季是月月都开花吗	月季的花期
月季的花期	不检索
月季和玫瑰是一种花吗	不检索
河源哪里有卖水果的	不检索
生活用品	大润发
做菜的好处	不检索
大润发	不检索
豆芽	豆芽做法
做菜的好处	不检索
好学的菜	好学的菜
凉拌豆腐需要准备什么材料	凉拌豆腐需要什么
西红柿炒鸡蛋	西红柿炒鸡蛋怎么做
西红柿炒鸡蛋	不检索
西瓜的好处	西瓜吃了
北方水果	北方的西瓜为什么比南方西瓜好吃
橘生淮南	夏季水果
荔枝吃太多	荔枝吃太多
荔枝的营养价值	不检索
摄影白平衡	不检索
摄影白平衡	摄影白平衡是什么
单反相机能调白平衡吗？	单反怎么调白平衡
单反白平衡	不检索
ps不熟不确定指的是哪个功能	不检索
谁是卧底	不检索
谁是卧底	《谁是卧底》手游
快乐大本营	玩游戏
朋友玩游戏	不检索
附近剧本杀店	附近剧本杀店
释迦	释迦水果
释迦的营养价值	释迦口感
释迦籽	释迦籽
释迦挑选	释迦挑选
释迦吃的注意事项	释迦挑选
芜湖市天气	不检索
学游泳的好处	如何学游泳
蛙泳	蛙泳
蛙泳运动员	蛙泳运动员
张远	不检索
林夕	二手玫瑰
东北二人转歌手	朴树歌手
朴树	不检索
那英	不检索
那英	不检索
狗狗生跳蚤怎么办	狗狗生跳蚤怎么办？
治跳蚤的药。	狗狗的跳蚤药名
灭虫宁	不检索
宠物店	不检索
狗狗吃了跳蚤怎么办	不检索
期中考试语文考了年级第一。	不检索
语文老师	不检索
语文阅读分析怎么做	语文阅读分析怎么做
阅读理解	不检索
阅读题	不检索
出租车上的耳机	不检索
入耳式耳机和头戴式耳机	入耳式耳机和头戴式耳机听力损害
头戴式耳机声音大	不检索
头戴式耳机听力损害	头戴式耳机听力损害
头戴式耳机的好处	入耳式耳机音质和头戴式
入耳式耳机音质	不检索
孩子学说话的经验	教孩子学说话第一步怎么办
孩子学说话的方法	不检索
如何让孩子复述	如何让刚会说话的孩子愿意开口
孩子学说话的方法	不检索
孩子学说话的方法	不检索
护理专业就业	不检索
保研	考公
考公	考公
考研	考公
保研	不检索
零食的含糖量	零食的含糖量
成年人一天摄入糖类的量	成年人一天摄入糖类的量
吃糖的危害	吃糖对皮肤的危害
吃糖的危害	不检索
戒糖的方法	吃什么容易长痘
吃辣的可以长痘吗	吃辣的会长痘吗
中国的生育率下降会有什么后果	中国的生育率下降会有什么后果
中国老龄化	不检索
生育率下降会有什么后果	不检索
中国公共福利政策	中国公共福利政策
中国老龄化问题	不检索
苹果的好处	柠檬的好处
柠檬酸	不检索
苹果派	苹果对人的好处
苹果的好处	不检索
苹果产地	不检索
上火的原因	不检索
中药推荐	不检索
上火怎么煮	不检索
吐鲁番药铺	不检索
北京同仁堂南十里居中医诊所	不检索
无聊的时候干什么	无聊
电影	电影
搞笑电影	不检索
喜剧电影	喜剧电影
喜剧电影	喜剧
人生的喜剧	不检索
孩子的成长需要父母陪伴吗	丧偶式育儿
丧偶式育儿	如何解决丧偶式育儿问题
丧偶式育儿	不检索
育儿方面的建议	如何更好的育儿
陪伴孩子的方法	不检索
手游	不检索
王者荣耀	不检索
王者荣耀	不检索
王者荣耀是哪个公司的游戏	王者荣耀是哪家公司的游戏？
王者荣耀的收入	王者荣耀营收。
滑雪的好处	滑雪
香港滑雪场	深圳滑雪
广州室外滑雪场	南方有室外滑雪场吗
湖北神农架滑雪场	香港去湖北神农架的交通
神农架滑雪场雪道	神农架滑雪场有几个雪道
滑雪技巧	不检索
滑雪技巧	不检索
绿萝怎么修剪	绿萝怎么修剪
绿萝的好处	绿萝好处
绿萝好养吗	不检索
绿萝养护	不检索
绿萝会开花吗	绿萝会开花
育儿知识	不检索
纯母乳和喂配方奶的区别	纯母乳和喂配方奶区别
母乳喂养的注意事项	母乳喂养应该注意问题
母乳喂养的好处	不检索
妈妈的育儿经验	不检索
吴磊	吴磊
长歌行演员	不检索
长歌行演员	吴磊骑马
舞剑	吴磊艺考
吴磊舞剑	不检索
什么水果降火	什么水果降火
冬天吃什么水果比较好	冬天吃什么水果比较好
柚子的好处	柚子的好处
柚子的降血糖作用	不检索
水果蔬菜放冰箱	蔬菜的好处
肠粉	肠粉
昌江天气	不检索
海南美食	海南美食
椰子糕	不检索
海南椰子糕	椰子糕品牌
大牌的东西	不检索
北鼎养生壶价格	北鼎养生壶价格
养生壶价格	养生壶品牌推荐
荣事达养生壶爆炸	不检索
荣事达养生壶价格	不检索
化妆	不检索
职业	职业
老师的职业	老师的工作
为什么要做博主	时尚博主
时尚博主	时尚博主
电视剧	不检索
裸婚时代	裸婚时代电视剧
裸婚时代电视剧	不检索
电视剧《裸婚时代》	电视剧蜗居
蜗居电视剧	不检索
股票	不检索
股票	不检索
2021年股市	不检索
2021年股市	不检索
2021年12月31日	不检索
开学	不检索
生活用品	需要买的生活用品
基本个人清洁类	基本个人清洁类生活用品
洗发膏、牙膏、肥皂、沐浴露、洗面奶、卸妆	不检索
家中常备医药品	家中常备医药品
早上喝酸奶的好处	早上喝酸奶有什么好处
早上喝酸奶的好处	空腹喝酸奶的坏处
空腹喝酸奶会导致胃酸浓度过高，对健康有害吗	酸奶怎么喝更健康
酸奶品牌	酸奶的品牌
新疆酸奶	新疆酸奶
地大物博美食	新疆美食
榴莲的营养价值	榴莲季节
榴莲的营养价值	榴莲制品
榴莲干	不检索
榴莲冰淇淋	榴莲冰淇淋八喜
八喜榴莲冰淇淋	不检索
余华	余华
余华的性格	余华的风格
许三观卖血记	许三观卖血记介绍
许三观卖血记	许三观卖血记特点
许三观卖血记简介	许三观卖血记简介
疫情宅	不检索
家常菜	健康家常菜
青椒和牛肉的搭配	青椒的营养价值
牛肉的营养价值	牛肉的营养价值
青椒吃多了会变胖吗	少盐少油的好处
毕业实习的公司	不检索
西安的公司	不检索
找工作	找工作
简历模板	简历模板
实习经验	实习经验
嘉兴景点	嘉兴市旅游
嘉兴的景点	乌镇
乌镇	嘉兴历史
嘉兴的历史	嘉兴市旅游
嘉兴的景点	不检索
吃播	吃播
吃播	不检索
吃播假吃	吃播假吃
吃播的危害	不检索
浪胃仙	不检索
大胃王密子君	大胃王密子君
什么职业最优秀	不检索
大学老师	大学生
大学老师	不检索
博士	博士
当大学老师的好处	申请博士
三体小说	三体小说
三体之地球往事	三体之地球往事
雨果奖	雨果奖
雨果奖	不检索
三体翻译	不检索
红楼梦	红楼梦简介
贾宝玉袭人	贾宝玉袭人
贾宝玉袭人	不检索
林黛玉	不检索
林黛玉	晴雯故事
经期不调	不检索
经期不调的原因	经期不调的丸药
经期不调的原因	经期不调的原因
经期不调的原因	不检索
晚上刷手机的危害	不检索
李宇春	李宇春
李宇春的歌	李宇春的歌
李宇春的粉丝	李宇春的粉丝
李宇春参加的节目	不检索
李宇春参加的节目	不检索
安踏运动装	不检索
安踏	安踏
安踏	不检索
安踏鞋子	安踏鞋子
安踏运动鞋	不检索
画眼线的技巧	不检索
画眼线的手	不检索
眼线笔品牌	不检索
kikonge眼线笔	如何画眼线
画眼线的教程	不检索
《我与地坛》	我与地坛
我与地坛	不检索
kindle	kindle泡面盖
酸酸辣辣豚骨面	关于美食的书籍
kindle泡面	不检索
牙膏推荐	不检索
牙膏挑选	牙膏什么成分有害
牙膏含氟	牙膏含氟会怎样
牙膏的特殊成分	牙膏什么成分能抑菌
牙膏的特殊成分	不检索
觉醒年代	不检索
民国时期的文化名人	胡适和北大
胡适	新文化运动
狂人日记	不检索
民国时期的新闻	不检索
电影《我是歌手》	不检索
青蛇电影	不检索
张曼玉	不检索
张曼玉演过的电影	张曼玉主演的电影
张曼玉	不检索
花样年华	花样年华剧情
活着小说	活着小说
活着的意义	不检索
许三观卖血记	余华作品
余华的第七天	不检索
余华的小说	现实主义小说余华
三毛的作品	三毛代表作
三毛的作品	三毛为什么受女生欢迎
三毛的浪漫爱情	荷西和三毛
荷西	不检索
三毛为什么吃安眠药	不检索
熬夜的危害	熬夜急救护肤品推荐
娇韵诗的护肤品	娇韵诗质量
干皮适合的护肤品	干皮适合的化妆品品牌
熬夜的危害	女生失眠怎么克服
睡前喝什么茶	不检索
银行的简介	银行的起源
银行是怎么来的	银行
银行的主要业务	银行的主要业务
银行的收入	银行靠什么赚钱
世界上最大的银行	世界上最大的银行
养生的方法	不检索
熬夜的危害	睡眠不足为什么可能猝死
猝死原因	猝死前兆
期末考	不检索
熬夜的危害	不检索
成龙	不检索
成龙	成龙
成家班	成家班
成家班	不检索
成家班的学习方法	不检索
五道口职业技术学院	不检索
清华专业	人工智能ai专业
人工智能行业	程序猿
程序猿工作辛苦吗	程序猿
程序猿在哪里	不检索
佟丽娅跳舞	不检索
佟丽娅	佟丽娅是哪里人
学习舞蹈的方法	学习舞蹈的方式
学习舞蹈的方法	不检索
坚持的好处	不检索
四大名著	中国的四大名著
西游记	不检索
红楼梦	不检索
林黛玉和贾宝玉的爱情	不检索
王熙凤	王熙凤有什么优点
骑山地车的好处	骑山地车注意事项
骑山地车需要准备什么	不检索
骑山地车注意事项	不检索
骑山地车检查	不检索
骑山地车的好处	不检索
花叶黄	花叶黄
花叶黄的原因	花叶黄
花叶黄的原因	不检索
吊兰	不检索
吊兰	不检索
冬奥会	冬奥会开始时间
黄山市天气	不检索
滑雪技术	奥运滑雪项目
黄山天气	黄山算南方的吗
短道速滑	短道速滑好玩吗
提子味的果汁	不检索
提子的营养价值	提子味道
深圳哪里的提子最好吃	哪里的提子最好吃
吐鲁番提子价格	吐鲁番的提子多少钱一斤
提子价钱	提子长相什么好
提子的品种	不检索
奇迹电影	不检索
易烊千玺	不检索
王俊凯	不检索
易烊千玺的电影	易烊千玺的新电影
易烊千玺的演技怎么样	易烊千玺电影得奖
诗歌发源于哪个朝代	不检索
诗歌的起源	不检索
《木兰诗》	不检索
苏轼	不检索
苏轼	不检索
宋诗	不检索
运动的好处	运动的好处
冬天的天气	不检索
明天的天气	明天的天气
爬山的好处	不检索
爬山注意事项	不检索
名著推荐	不检索
名著推荐	凡尔纳
凡尔纳	不检索
神秘岛故事	不检索
凡尔纳	凡尔纳
凡尔纳	不检索
俄罗斯花滑运动员	俄罗斯花滑运动员
谢尔巴科娃	谢尔巴科娃
中国花滑运动员	中国花滑运动员
滑冰	不检索
滑冰会摔跤吗	不检索
盐城美食	不检索
盐城美食	盐城美食
野鸭灌汤包	盐城野鸭灌汤包
盐城野鸭灌汤包	盐城小吃
盐城美食	盐城小吃街
养猫的好处	不检索
送人的猫	不检索
掉毛严重的猫	英国短毛猫
养狗的好处	养猫还是养狗
拉萨的猫	去哪里买猫
养生从什么时候开始比较合适	养生从什么时候开始比较合适
养生的年龄	不检索
养生的年龄	不检索
养生应该做什么	养生应该做什么
养生的方法	不检索
无聊的时候做什么	不检索
植物大战僵尸	植物大战僵尸
qq飞车	不检索
qq飞车	qq飞车
qq飞车	不检索
qq飞车	不检索
四小花旦	不检索
80四小花旦	80四小花旦
90四小花旦	90四小花旦
四小花旦	不检索
神仙姐姐	神仙姐姐
科比去世	科比去世
科比去世	不检索
科比	不检索
科比号码	两个号码的球星
科比是什么时候换的号码	不检索
博士毕业	不检索
博士毕业后工作	不检索
成都的好处	成都
成都的好处	不检索
博士	不检索
寒假学做饭	不检索
宁夏特色菜	宁夏特色菜
黄河鲶鱼	大蒜烧黄河鲶鱼
大蒜烧黄河鲶鱼	大蒜烧黄河鲶鱼
大蒜烧黄河鲶鱼独门秘诀	不检索
作家	不检索
史蒂芬金	史蒂芬金
史蒂芬金	不检索
史蒂芬金	史蒂芬金
史蒂芬金的小说	不检索
北方的感觉	不检索
大澡堂	大澡堂
搓澡巾	搓澡巾
搓澡巾	不检索
搓泥巾	搓泥
开封美食	开封的美食
开封的芥菜肉	开封的芥菜肉
芥菜肉	不检索
开封美食	不检索
开封美食	不检索
洁癖的危害	不检索
处女座	天蝎座的特点
天蝎座精神	不检索
相信星座的人	陶白白
陶白白	不检索
软件开发工作	不检索
软件开发工程师	软件开发薪资
软件开发薪资	软件开发面试
软件开发简历	软件开发简历
简历模板	不检索
流感	冬天的流感
咽痛的原因	怎么缓解咽痛
蜂蜜的好处	蜂蜜的好处
蜂蜜护肤美容	护肤美容的食物
治疗咽痛的食物	治疗咽痛的食物
治疗咽痛的食物	不检索
英语考试	不检索
期末考试	不检索
英语考试	英语考试技巧
背单词的方法	英语背单词
记忆英语单词的方法	不检索
驻马店房价	附近房地产最近景气吗？
赚钱的方法	附近的房价
北上广深房价	房价为什么这么贵啊？
驻马店市房价	该市的经济环境发展状况
未来的房价趋势	未来的房价
未来的房地产景气吗	房地产的未来趋势会如何？
软件开发实习	不检索
软件开发岗位	软件开发岗位
大数据开发工程师	大数据开发工程师
大数据开发工程师的工资	大数据开发工程师薪资
大数据开发工程师的工资	不检索
吃辣的危害	不检索
吃辣的危害	不检索
吃辣的危害	胃疼需要吃什么药
喝什么能解辣	喝什么东西能解辣
喝牛奶的好处	不检索
蛋挞的做法	不检索
蛋挞	不检索
自制甜品	自制甜品
蛋挞	不检索
空气炸锅	不检索
春天穿搭	不检索
春天穿搭	春天的穿搭
衬衫的品牌。	衬衫的品牌
夏尔凡	夏尔凡品牌
便宜的衬衫	便宜的衬衫
衬衫价格	不检索
星座	星座由来
星座的起源	十二星座介绍
十二星座	十二星座介绍
3月24日出生的星座	十二星座
双鱼座的特点	双鱼座性格特点
哈利波特魔法觉醒	不检索
哈利波特魔法觉醒卢娜	哈利波特魔法觉醒卢娜打法
吼叫信吼到人	吼叫信打法
哈利波特魔法觉醒	不检索
哈利波特魔法觉醒魔法觉醒	不检索
驾照科目	驾照科目
场地驾驶科目二科目三科目四科目五科目六科目七科目	不检索
驾照科目二科目三科目四科目五科目六科目七科目八	驾照科目二考试技巧
路上车多怎么办	路上车多怎么办
路上车多怎么办	不检索
隆基	隆基
隆基如何做单	不检索
股市的风险	不检索
乌克兰股市	乌克兰股市
隆基	股市不要把鸡蛋放在同一个篮子里
广西钦州市天气	广西壮族自治区钦州市天气
长跑的好处	不检索
刘翔	不检索
刘翔的成就	刘翔第一枚奥运金牌
刘翔	不检索
tcl液晶电视	液晶电视好处
液晶电视牌子	液晶电视牌子推荐
索尼液晶电视	索尼液晶电视
液晶电视的品牌	不检索
学习液晶电视的专业	不检索
手机品牌	手机品牌
5000元的手机	5000元的手机
适合女生用的手机	适合女生用的手机
附近的手机品牌	附近手机店
附近的商场	不检索
刘学义	刘学义
刘学义	刘学义演技
刘学义	刘学义主演
刘学义的粉丝群	刘学义应援
刘学义	不检索
吃中药的危害	不检索
中医和西医的区别	不检索
中医和西医的区别	中医和西医的区别
中医和西医的区别	不检索
调和身体的药	调和身体更适合看中医还是西医
胖的原因	不检索
胖的原因	1m65。150斤。很胖吗？
体脂率高的危害	不检索
肥胖会不会更容易生病	肥胖容易导致哪些疾病？
肥胖的危害	不检索
找工作的软件公司	不检索
土木工程毕业就业	土木工程毕业可以从事什么职业
施工员的薪资	工程师的薪资一个月是多少
在哪里可以找工作	在哪里找工作
前程无忧	不检索
工作压力	舒缓工作压力
同事的优点	不检索
妈妈工作压力	不检索
办公室的领导和同事的性格	不检索
上班戴耳机听歌	不检索
赵雷的歌	赵雷的歌曲
金华市中医院	金华市中医院
金华市中医院	不检索
睡得不好的原因	失眠解决办法
睡不好的危害	不检索
金华市中医院	不检索
内江天气	内江天气
内江天气	内江羽毛球馆
内江天气	羽毛球技巧
羽毛球技巧	不检索
林丹	林丹
暴力摩托	暴力摩托
暴力摩托	不检索
暴力摩托动画片	不检索
喜羊羊被举报	喜羊羊被举报的原因
喜羊羊被举报	不检索
外国电影	不检索
好看的外国电影	好看的外国电影
新出的外国电影	新出的外国电影新出的外国电影
看电影的网址	看电影的网址看电影的网址
圣城家园	不检索
中药有用吗？	中医有用吗
月经不调吃什么中药	月经不调吃什么中药
月经不调吃什么中药	不检索
月经不调吃什么药	月经不调吃什么药
月经不调吃什么药	不检索
现代诗歌欣赏	不检索
有名的现代诗人	有名的现代诗人
海子的争议	海子的争议
海子的诗歌	关于海子的诗歌的课题
海子的诗歌	不检索
玩游戏的好处	不检索
王者荣耀	王者荣耀
王者荣耀	不检索
阴阳师	阴阳师
阴阳师	不检索
脖子疼	颈椎北京医院推荐
针灸疗效	针灸疗效
针灸疼吗	针灸疼吗
针灸的好处	不检索
针灸疼吗	不检索
星座	不检索
星座	不检索
双鱼座今日运势	双鱼座今日运势
星座的由来	星座的由来
陶白白	陶白白
王者荣耀	王者荣耀
王者荣耀刺客	王者荣耀的刺客
王者荣耀的英雄	不检索
王者荣耀射手	王者的射手
王者荣耀射手	王者荣耀的精神
王者荣耀的打法	不检索
零食	不检索
山楂肉	不检索
山楂零食	不检索
好吃的零食	好吃的零食品牌。
徐福记的零食	不检索
徐福记大礼包的价格。	徐福记的大礼包价格是多少？
世界名著	名著
红楼梦	红楼梦
红楼梦	不检索
石头记	不检索
红楼梦	不检索
红楼梦的作者	不检索
西宁水果	不检索
荔枝	荔枝
苹果	苹果
富含维生素c的水果	富含维生素c的水果
西宁水果	吃水果的好处
考研和就业的区别	不检索
英语专业考研	英语专业适合考研吗
英语专业的就业方向	英语专业适合从事什么职业
英语专业就业	不检索
英语专业就业	不检索
河北衡水的美食	不检索
做一桌菜要花很久。	不检索
糖醋里脊	糖醋里脊多长时间
糖醋里脊	糖醋里脊
糖醋里脊	家常菜汤
糖醋里脊	不检索
柿子成熟	柿子成熟
柿子成熟的时间	柿饼
柿饼硬	不检索
贵州柿饼产地	不检索
陕西富平吊柿	不检索
最近的电视剧	2021年电视剧
庆余年张若昀	庆余年张若昀
古装剧	古装剧2021年
验尸官	验尸官
tvb法医电视剧	tvb法医电视剧
佘诗曼法证先锋	不检索
养宠物的好处	不检索
柯基	柯基
柯基	不检索
柯基掉毛吗	柯基掉毛吗
柯基掉毛	不检索
考研和就业的路	不检索
考研的学校	不检索
考研的流程	考研
考研调剂	考研调剂
考研复试	不检索
考研复试	不检索
考研复习	不检索
父母是否要孩子	不检索
生孩子的危害	怀孕有哪些弊端
生孩子的危害	不检索
孕妈妈的责任	如何发扬女权主义
女性的性观念	不检索
冬残奥会	不检索
轮椅轮椅	轮椅冰壶
轮椅冰壶	不检索
假肢的普及度	国内能做假肢吗
轮椅风行者未来可期	不检索
连云港	连云港
连云港	连云港
连云港	连云港
连云港景点	连云港
连云港景点	连云港景点
甄嬛传	不检索
甄嬛传	甄嬛传
孙俪	孙俪的作品
《甜蜜蜜》	不检索
孙俪和丈夫的电视剧	不检索
膨化食品	膨化食品长胖
浪味仙	不检索
浪味仙	浪味仙
浪味仙	不检索
浪味仙	不检索
多动症	不检索
为什么不听课	不检索
成人多动症	确诊成人多动症挂儿科
成人adhd治疗方法	成人adhd如何治疗
成人adhd吃什么药	托莫西汀是处方药吗
成人adhd挂儿科	不检索
保亭县	不检索
火烧赤壁的赤壁	不检索
火烧赤壁的历史	火烧赤壁历史
赤壁历史文化名城	不检索
文赤壁	不检索
漠河舞厅	不检索
柳爽跳的舞	不检索
《漠河舞厅》的含义	《漠河舞厅》的背后故事
柳爽的爱情	不检索
《漠河舞厅》的歌词	不检索
柳爽的歌	柳爽
学画画的好处	不检索
理发师	理发师
化妆	不检索
化妆的好处	不检索
美妆视频	美妆博主
手机屏幕压碎	不检索
华为mate8	华为p50pro
华为p50pro价格	华为p50pro价格
华为p50pro价格	新疆维吾尔自治区昌吉回族自治州天气
昌吉天气	不检索
李佳琦直播间	不检索
mac粉底液价格	mac粉底液色号
兰蔻口红颜色	如何挑选口红色号
兰蔻196色号	不检索
兰蔻口红	不检索
吃鸡游戏	吃鸡游戏
吃鸡游戏	不检索
吃鸡游戏	陈赫baby吃鸡
陈赫直播	不检索
英雄联盟	不检索
美国电影太炸裂	不检索
《消失的爱人》	《消失的爱人》
美国电影消失的爱人	美国电影消失的爱人女主演
大卫芬奇	大卫芬奇导演的电影
《七宗罪》	不检索
中考时间	不检索
荆州高中	荆州什么高中好
沙市中学高考	荆州中学文理哪个好
荆州的教育	不检索
荆州的教育	不检索
洛克王国	洛克王国
洛克王国	不检索
洛克王国网页版	不检索
支持flash的浏览器	为什么现在的浏览器不支持flash了
支持flash的浏览器	支持flash的浏览器
忻州市的美食	不检索
忻州美食	不检索
忻州瓦酥	忻州瓦酥
忻州瓦酥	神池月饼哪里卖
神池月饼	不检索
鞋子的品牌。	不检索
回力的鞋子	回力的历史
回力的质量好吗	回力鞋子质量好不好
回力鞋子	香港离岛回力旗舰店
回力的鞋子	不检索
自由职业的好处	不检索
自由职业的好处	不检索
自由职业	自由职业
摄影的好处	自由职业摄影
自由职业	不检索
四川美食	四川美食
夫妻肺片	不检索
夫妻肺片怎么做	夫妻肺片怎么做
廖记棒棒鸡	不检索
晚上吃什么	不检索
小幸运	《小幸运》是什么电视的主题曲
《小幸运》的歌词	《小幸运》的歌词
《小幸运》的歌词	《小幸运》代表什么
小幸运	一个寝室的音乐可以带来什么
小幸运	不检索
小幸运音乐会	附近的超市
推荐的历史书	不检索
唐代的风土人情	唐代历史类相关书籍
推荐的历史类书籍	《半小时漫画中国史》
二混子	不检索
《隋唐五代史》	《唐太宗政变24小时》
《唐太宗政变24小时》	不检索
漫威电影	漫威
黑豹演员去世	黑豹演员去世
黑寡妇	斯嘉丽约翰逊
美女干事业	不检索
漫威人物最跳脱的就是蜘蛛侠	不检索
南阳天气	南阳天气
南阳美食	不检索
新野臊子	新野臊子
新野臊子做法	新野臊子做法
新野臊子做法	不检索
五一假期去哪里旅游	五一假期旅游景点推荐
五一假期人少的地点又好玩的地方	五一假期人少的地点又好玩
自驾游注意事项	自驾游注意事项
五一假期出游	出游交通方式
福建除了霞浦还有其他好玩的地方	福建除了霞浦还有其他好玩的地方
塑料纸	鞋子塑封膜
塑封膜	不检索
生活用品	不检索
贴画	木浆棉洗碗擦
洗碗布的价格。	不检索
拼多多生活小物	不检索
南阳周末天气	这周末南阳的天气
南阳今天的天气	不检索
南阳下周三天气	不检索
南阳天气	不检索
南阳今天的天气	南阳下周三天气
热带水果	热带水果有哪些
椰子水的营养价值	不检索
热带水果为什么甜得要命	热带水果糖分和气候有关吗
热带水果的营养价值	不检索
热带水果的产地	不检索
掉皮的原因	不检索
面霜推荐	不检索
面霜推荐	不检索
干皮和油皮的区别	基础护肤
淘宝天猫旗舰店	附近商场
结婚的年龄	不检索
结婚的好处	不检索
组建小家庭的准备	如何为组建家庭准备
家庭是爱的港湾	备孕需要注意的事情
如何改掉不良生活习惯	不检索
辣条	不检索
辣条是什么时候发明的	辣条发明
辣条起源于哪里	不检索
卫龙	辣条起源
吃辣条的危害	卫龙
基础的股票知识	不检索
学习股票知识的网站	学习股票知识的方法
股票投资的风险	股票投资有哪些风险
投资股票的注意事项	不检索
学习股票知识的方法	如何学习股票知识
现代人的常见病	现代人的常见身体疾病
糖尿病	不检索
身体不调的病	不检索
中药的好处	中药的忌口
健康的饮食	不检索
平板电脑	不检索
平板电脑的作用	不检索
平板电脑的作用	不检索
苹果平板电脑	不检索
苹果平板电脑	不检索
余华	不检索
活着电影	不检索
活着电影	电影活着获奖
余华的作品	余华的特点
余华的作品	许三观卖血记的特点
中国四大名著	不检索
水浒传江湖气派	水浒传江湖气派
逼上梁山	逼上梁山的故事
林冲逼上梁上	林冲逼上梁上反映的社会现象
林冲逼上梁上反映的社会现象	不检索
新冠疫情	新冠疫情
新冠变异	变异新冠
新冠国内安全吗	英国新冠
新冠疫情	预防新冠
新冠口罩	新冠医用外科口罩
戳爷	戳爷
怎么安慰戳爷	不检索
a妹	a妹
a妹和戳爷合作一首歌	a妹和戳爷有合作一首歌
a妹	不检索
买基金的注意事项	买基金
买基金的好处	不检索
买基金的注意事项	基金推荐
富田国天惠和嘉实泰和一次性买多少钱	不检索
买基金的原则	买基金的原则
王者荣耀	不检索
王者荣耀	手游
王者荣耀	不检索
王者段位	不检索
王者的路	不检索
国产动漫	推荐的动漫
妖精的尾巴	不检索
妖精的尾巴漫画	不检索
《妖精的尾巴》的漫画	推荐的漫画
《自白》	不检索
学习摄影的方法	不检索
风景摄影	不检索
北京值得摄影的景点	北京值得摄影的景点
朝阳区的景点	北京朝阳区的景点
三里屯和798艺术区	不检索
明朝那些事儿	明朝那些事儿介绍
明朝那些事儿	明朝那些事儿介绍
明朝历史	明朝历史
明朝的历史	明朝历史
明朝末年	明朝末年
网购妇女节优惠	淘宝妇女节
女王节化妆品	女王节淘宝
唇妆	不检索
底妆选择	不检索
眼妆	不检索
眼霜推荐	眼袋、黑眼圈、鱼尾纹的眼霜推荐
眼霜100块钱和1000块钱的区别	眼霜100块钱和1000块钱的区别
眼霜推荐	不检索
眼霜实体店还是网购	不检索
平价眼霜推荐	不检索
老年人的常见病	老年人常见病
老年人的心脏	老年人的心脏
老年人的心脏	预防心脏病
预防心脏病的方法	预防心脏病
低盐低脂食物	对心脏好的食物
保护心脏的食物	不检索
《我的世界》	我的世界游戏
我的世界博主造的建筑	不检索
我的世界游戏	逃离方块
解谜游戏	不检索
逃离方块游戏	不检索
生活无聊	不检索
养猫的好处	不检索
英短	养英短的好处
英短价格	推荐养的平价猫
猫咖	不检索
野史是什么	野史
相信野史吗	相信野史
新疆野史	新疆野史
新疆的历史	新疆历史查询资料
新疆旅游	从北京到新疆的火车
新疆特产	不检索
舞蹈能减肥吗	舞蹈可以减肥吗
舞蹈减肥	不检索
学舞蹈的基础	初学者适合的舞种
肚皮舞学习	肚皮舞的学习技巧
肚皮舞学习	不检索
熬夜的危害	熬夜的危害
熬夜对皮肤的危害	熬夜引起肥胖
熬夜的危害	不检索
熬夜的危害	熬夜后怎么办
熬夜的危害	不检索
珠宝设计师	不检索
国外的珠宝设计师	国外的珠宝设计师
美国手工珠宝设计师brucemetcalf	不检索
国内的珠宝设计展	2022年国内的珠宝设计展
天津梅江会展中心	不检索
养生的好处	不检索
养生汤盅	养生汤盅
鲫鱼汤做法	鲫鱼汤做法
鲫鱼汤做法	鲫鱼汤做法
鲫鱼汤做法	不检索
鲫鱼汤做法	不检索
钓鱼的好处	钓鱼
武威市钓鱼场所	武威市钓鱼场所
钓鱼需要准备什么	钓鱼渔具
钓鱼技术	不检索
钓鱼的诀窍	不检索
男足的比赛	男足对越南
男足比赛	不检索
中国男足明天的比赛	不检索
男足踢什么球	不检索
男足踢了几场球	男足为什么踢这么差
可乐鸡翅	可乐鸡翅
可乐鸡翅	不检索
芒果西米露	芒果西米露
鸡蛋羹	鸡蛋羹
鸡蛋羹做法	不检索
大秦帝国	不检索
秦始皇	秦始皇
汉武大帝	汉武大帝
汉武大帝	陈宝国汉武帝
陈宝国演的刘彻	不检索
东宫男主角	东宫男主角
陈星旭	陈星旭作品
陈星旭	陈星旭毕业院校
陈星旭导演	东宫导演
东宫导演	不检索
长痘痘的原因	长痘痘原因
吃甜食的坏处	吃甜食长痘
长痘的原因	不检索
心情不好的时候做什么	缓解心情不好的方式
心情不好的时候可以做什么	不检索
康熙王朝	康熙王朝
康熙王朝	康熙王朝
陈道明	陈道明
陈道明的电视剧	陈道明
末代皇帝	末代皇帝电影
火锅的好处	不检索
重庆火锅	重庆火锅
秦妈火锅素菜	yyds是什么意思
莴笋的营养价值	莴笋怎么涮火锅
牛肉的营养价值	火锅麻辣牛肉
西游记中九九八十一难的最后一难是什么	西游记中九九八十一难的最后一难是什么
通天河老鼋	通天河老鼋
西游记好玩的剧情	西游记好玩的剧情
西游记的剧情	孙悟空
孙悟空的故事	不检索
大学生就业	不检索
大学生就业专业	不检索
统计学的就业方向	不检索
统计学专业就业前景	不检索
考研学什么	不检索
觉醒年代	觉醒年代播出时间
觉醒年代剧情	觉醒年代情节
觉醒年代	觉醒年代情节
觉醒年代	觉醒年代情节
觉醒年代	新文化运动
觉醒年代	不检索
烟台的景点	不检索
烟台景点	不检索
烟台景点	烟台美食
烟台景点	烟台景点
烟台景点	不检索
张继科退役	张继科退役
张继科	张继科综艺
张继科训练	张继科上综艺影响训练吗
张继科	张继科冠军
张继科	不检索
考试的时候什么都想不起来	不检索
考试紧张	不检索
缓解紧张情绪的方法	不检索
考试紧张	不检索
考试期间的饮食	考试期间的饮食安排。
人工智能的应用	人工智能的介绍
人工智能图像识别领域	人工智能的图像识别领域能做什么
人工智能的意义	不检索
人工智能的前景	不检索
人工智能的专业人士	不检索
高考专业	高考专业怎么选
设计专业学什么	设计类专业学什么
数字媒体艺术专业	不检索
数字媒体技术和数字媒体艺术	数字媒体技术和数字媒体艺术一样么
数字媒体技术和数字媒体艺术的区别	不检索
奚梦瑶	奚梦瑶的职业
奚梦瑶	不检索
奚梦瑶的影视作品	不检索
奚梦瑶的老公	奚梦瑶的老公是谁
何猷君	不检索
水果的好处	吃水果的好处
水果汁的好处	水果汁搭配
酸香蕉莓果奶昔怎么做	不检索
吃水果的好处	不检索
酸奶的营养价值	凉山彝族自治州天气
特步鞋子	特步鞋子
特步鞋子	鞋子的寿命
家里的鞋子不能穿	不检索
鞋子怎么清理	鞋子怎么清理
鞋子的颜色	不检索
出生时间	不检索
狮子座	狮子座
射手座	射手座
射手座12月21日	7月14号是什么星座
射手座	射手座性格
奶茶的好处	奶茶为什么不健康
奶茶的营养价值	不检索
奶茶的好处	奶茶品牌推荐
奶茶品牌	不检索
奶茶的甜	不检索
番茄味薯片	喜欢黄瓜味薯片
自制薯片	自制薯片
薯片的做法	黄瓜味薯片
黄瓜味薯片	不检索
薯片价格	薯片价钱
世界上最贵的薯片	该死的资本主义
卫星外层涂什么耐高温材料	卫星外层涂什么耐高温材料
人类在卫星舱里会有什么反应	宇航员在太空中
宇航员的氧气瓶能支撑多久	宇航员的氧气瓶能支撑多久
去一次太空会给宇航员带来什么身体影响	人类在卫星舱里会有什么反应
人类在卫星舱里会有什么反应	不检索
人工智能	人工智能是什么
人能和人工智能机器人恋爱吗	恋爱
人工智能	不检索
人类的故事	人类的故事
人类的起源	不检索
《鬼灭之刃》	《鬼灭之刃》
《鬼灭之刃》	不检索
《鬼灭之刃》	不检索
《鬼灭之刃》	宫崎骏
《千与千寻》	不检索
《鬼灭之刃》	不检索
日本动漫	日本好看的动漫
鬼灭之刃	鬼灭之刃属于哪类动漫
鬼灭之刃中的角色	你喜欢鬼灭之刃中的哪一个角色
善逸	善逸评价
善逸	不检索
上海交通怎么样	上海的交通怎么样啊
上海交通大学	上海交通大学位置
上海交通大学高考录取分数线	上海交通大学山东录取分数线
上海交通大学	不检索
山东高考分数线	不检索
小说影视化	不检索
电视剧选角	影视化选角
琅琊榜	《琅琊榜》
琅琊榜电视剧	琅琊榜电视剧
孔笙	不检索
上海明日天气	上海最近的天气
上海好玩的景点	上海好玩的景点
上海迪士尼	上海迪士尼
上海迪士尼	上海迪士尼
上海迪士尼项目	不检索
上海迪士尼	不检索
冬天的保暖方法	不检索
开封天气	不检索
支气管炎	支气管炎
高血压	高血压
减肥的方法	减肥方法
减肥的方法	不检索
现在还有人看电视吗？	不检索
老年人看电视	不检索
电视屏幕大	tcl
手机的品牌。	不检索
手机品牌	不检索
上班的好处	不检索
孩子不写作业怎么办	孩子不写作业怎么办
孩子不爱写作业的原因	不检索
孩子写作业的方法	物质奖励孩子
孩子写作业的物质奖励	不检索
螺狮粉	螺狮粉味道
河池市小吃	清淡小吃
擂沙圆	擂沙圆
芸豆卷	芸豆卷
芸豆卷	不检索
听音乐的好处	音乐对人的影响
没有音乐的世界	不检索
韩国女团	韩国有哪些女团
twice	twice有哪些歌曲
twice的歌	不检索
无毛猫	猫的好处
养猫的好处	养猫的好处
养猫的好处	猫的优点
猫毛过敏	无毛猫
无毛猫	无毛猫的优点
无毛猫	不检索
北京的景点	不检索
摄影的好处	不检索
为什么喜欢摄影	摄影感兴趣
摄影的技术要求	摄影需要技术
摄影的技术要求	不检索
龙猫怎么养	龙猫怎么养
龙猫是猫吗	龙猫是猫吗
龙猫的养法	龙猫怎么养
龙猫的寿命	龙猫的寿命
龙猫的寿命	不检索
做菜的好处	不检索
番茄炒鸡蛋	番茄炒鸡蛋做法
回锅肉	回锅肉做法
黄花鱼怎么煎	黄花鱼怎么煎
黄花鱼怎么煎	不检索
父母吵架	不检索
父母吵架	父母吵架
家庭幸福	家庭幸福
和爸妈沟通	不检索
定安县天气	不检索
书气自华	不检索
二手书网站	二手书网站推荐
电子书	不检索
手机看电子书	电子阅读器
电子书阅读器	电子书阅读器品牌
鬼灭之刃	鬼灭之刃
鬼灭之刃游郭篇	鬼灭之刃游郭篇
鬼灭之刃无限列车篇	鬼灭之刃动漫无限列车篇
鬼灭之刃结局	鬼灭之刃主题曲
鬼灭之刃推荐	日本人气动漫
神探夏洛克	不检索
好看的小说	不检索
好看的网文小说	莫斯科绅士
莫斯科绅士	埃默托尔斯是俄国人吗
《上流法则》	余华小说
余华的小说	不检索
武则天	武则天
武则天的才气	历史上的女政治家
吕雉	吕雉
吕雉	不检索
吕雉	不检索
考试不理想	不检索
考试紧张怎么办	考试紧张
考试紧张怎么办	考试紧张
考试知识掌握的不牢固	不检索
考试记知识点的方法	记忆技巧
考试时的技巧	不检索
化妆的危害	不检索
化妆步骤	化妆步骤
新手化妆应该开始	新手化妆从哪里开始？
新手画的画	不检索
美妆博主	不检索
粑粑柑	粑粑柑
粑粑柑	粑粑柑
粑粑柑的名字	不检索
粑粑柑	不检索
粑粑柑	不检索
长津湖电影	2021年热门电影
电影长津湖票房冠军	2021票房冠军
你好李焕英	你好李焕英
长津湖电影	不检索
长津湖电影	长津湖电影
长津湖电影	电影长津湖
肥皂的名字。	肥皂是用来冲洗污垢的清洁剂，词源“吹脏”
肥皂的起源	肥皂中国
肥皂的发明者	肥皂作用
肥皂洗衣服	肥皂洗衣服
肥皂衣柜	肥皂衣柜
肥皂的作用	不检索
当宇航员	不检索
中国未来几年的载人航空计划	中国未来几年的载人航空计划
现在在空间站的航空员	不检索
国际空间站	国际空间站
国际空间站	不检索
黄晓明杨颖离婚	不检索
黄晓明杨颖离婚	杨颖和黄晓明怎么认识的
杨颖和黄晓明的绯闻	不检索
华晨宇	华晨宇歌曲
华晨宇和张碧晨的责任	不检索
找工作	不检索
教师的工作	不检索
教师资格证	不检索
教师资格证考试	不检索
缓解压力的方法	不检索
三沙市景点	三沙旅游
三沙市	三沙市
三沙市旅游价格	三沙旅游消费
三沙市船票	不检索
三沙市的景点	不检索
减肥的运动	减肥的运动
有氧和无氧有什么区别	有氧和无氧运动的区别
有氧的运动减肥更快吗	有氧运动和无氧运动哪个能减肥
游泳	不检索
游泳泳姿	泳姿有几种
辽宁省阜新市天气	辽宁省阜新市天气
辽宁省阜新市天气	不检索
漫威电影	漫威
荷西	汤姆赫兰德
汤姆赫兰德	不检索
水浒传	水浒传
水浒传翻拍版	水浒传央视版谁拍的
水浒传主题曲	央视版水浒传主题曲
二胡独奏版本	二胡名曲赛马
民族乐器的流行	闪光少女
nike的衣服	不检索
nike的衣服	不检索
nike裤子	耐克的裤子推荐。
nike裤子多少钱	nike裤子价格
nike裤子多少钱	不检索
兔子难养吗	兔子难养
兔子吃什么	兔子吃食
养兔子要注意什么	养兔子注意事项
兔子驱虫	兔子驱虫
兔子驱虫	不检索
肌肉酸痛	运动肌肉酸痛
拉伸的好处	拉伸运动
坚持运动的好处	不检索
自己练的时间	不检索
朋友一起运动	不检索
香港天气	不检索
宠物店	不检索
拆家的小狗	拆家的小狗
聪明温柔智商高的狗	金毛犬
金毛犬	不检索
恩施天气	不检索
雪人	不检索
哈尔滨的雪	哈尔滨的雪
哈尔滨的雪	哈尔滨的著名景点
哈尔滨的景点	哈尔滨的景点
哈尔滨景点	不检索
知否电视剧	类似《知否知否，应是绿肥红瘦》的电视剧
琅琊榜	电视剧琅琊榜无聊弃剧
胡歌	不检索
尔淳玉莹孙太医	《金枝欲孽》尔淳玉莹
尔淳玉莹	不检索
排名	不检索
国王排名	国王排名动漫
勇者斗恶龙	jojo的奇妙冒险
jojo的奇妙冒险	不检索
咒术回战	咒术回战故事
冬奥会金牌	不检索
韩国人嫌弃我们的饭菜	不检索
网络上的吉祥物	不检索
冰墩墩的cp	冰墩墩地cp
雪融融	不检索
疫情	不检索
计算机专业就业方向	计算机专业就业方向都有啥呢
互联网公司待遇	不检索
机器学习的公司	中国有哪些企业做机器学习，人工智能
机器学习公司	不检索
闺蜜合作养老	闺蜜合作养老
闺蜜合作养老	当代年轻人不谈恋爱
合作养老	不检索
养生堂	不检索
做饭的好处	不检索
最好的诗	最好的诗
春江花月夜	春江花月夜
春江花月夜	春江花月夜
春江花月夜	春江花月夜评价
春江花月夜	春江花月夜景色
烧烤的好处	不检索
烧烤的种类	烧烤种类
烧烤的种类	烧烤种类
烧烤的好处	烧烤的坏处
烧烤的好处	不检索
深圳高校男女比例	不检索
女生图书馆	女生图书馆
深圳大学女图书馆	深圳大学
深圳大学	深圳大学保研名额紧张
深圳大学保研	不检索
科幻小说	不检索
刘慈欣	刘慈欣
流浪地球电影	《流浪地球》
电影《流浪地球》	不检索
《三体》	《三体》
《三体》	不检索
水瓶女是什么性格的星座	水瓶女的性格
喜欢水瓶座的男生	水瓶男是什么性格
水瓶座性格	水瓶座速配星座
双子座和水瓶座配对指数	不检索
水瓶座和双子座的性格	不检索
西宁商场	不检索
798艺术园	不检索
肥皂粉和洗衣粉的区别	不检索
洗衣服液	不检索
洗衣液	不检索
工行消费券	啊，工行消费券。
工行消费券	不检索
工商银行的消费券。	不检索
工商银行的银行卡	不检索
手机银行app	手机银行app就可以申请一张卡
考研	考研人数
考研和工作的区别	考研和工作如何选择
考研难度	不检索
考研时间	不检索
考研时间	不检索
冬奥会	不检索
冬奥会在哪里举办	不检索
北京冬奥会	不检索
什么是花样滑冰	什么是花样滑冰
花样滑冰	冰球
冰球	不检索
穿搭风格	不检索
骑摩托穿什么样的衣服	骑摩托穿什么样的衣服骑摩托穿什么样的衣服
骑摩托皮衣	不检索
皮衣搭配	不检索
穿什么颜色的靴子好看	穿皮衣搭配什么颜色的靴子好看
灰色短靴	不检索
小王子	小王子
时光一去不复返	怀念小时候的时光
怀念小时候的时光	不检索
颓废的原因	如何从颓废状态振奋起来
如何走出颓废	不检索
苏州美食	苏州美食
松鼠桂鱼	松鼠桂鱼做法
松鼠桂鱼蒸	不检索
苏州博物馆	苏州博物馆设计
苏州园林	苏州园林推荐
从无锡到苏州的火车时间	到苏州拙政园怎么走
口红推荐	不检索
红调的口红	红调的口红好看么
口红色号	口红怎么薄涂
阿玛尼400怎么涂	不检索
阿玛尼400	阿玛尼400
西方的作家	不检索
西方作家	西方作家
西方作家	西方作家
马克吐温	马克吐温
马克吐温	不检索
有氧运动和无氧运动的区别	有氧运动有哪些
有氧运动和无氧运动的区别	有氧运动是根据心率划分吗
有氧运动能增强体力吗	有氧和无氧哪个更好
有氧和无氧的区别	不检索
睡前运动对身体有害吗	不检索
小饼干	不检索
好利来的半熟芝士	好利来
徐州蛋糕店	附近的蛋糕店
徐州市天气	徐州市天气
徐州市天气	不检索
糖尿病	糖尿病
糖尿病年龄	不检索
糖尿病患者为什么要喝含糖高的饮料	不检索
控糖的好处	控糖
榨果汁的好处	不检索
三体	三体
刘慈欣三体	刘慈欣三体
三体小说	不检索
三体第一部	三体第一部
三体的内容	不检索
三体的内容	不检索
红色外套搭配什么裤子穿才好看	红色上衣配什么裤子
黑色的优点	不检索
红色上衣配什么鞋子	红色大衣配什么鞋子
白色运动鞋	不检索
白色运动鞋	不检索
股票市场行情	股票市场行情的影响
股票知识入门	如何入门股票
买股票的好处	不检索
股票市场规则	不检索
什么事会有潜规则	不检索
sallyface	sallyface。
sallyface	不检索
sallyface游戏	不检索
sallyface游戏	sallyface游戏。
sallyface游戏	不检索
天天向上	天天向上电视节目
天天向上主持人	天天向上主持人
大张伟	大张伟唱歌
大张伟倍儿爽	歌词倍儿爽
大张伟倍儿爽	不检索
车厘子	冬天时令水果
车厘子价格	车厘子
新冠病毒	水果消毒
水果的好处	不检索
荔枝上火	不检索
四级考试和六级考试可以同时报名	四级考试和六级考试可以同时报名
四级考试难吗	四级考试难吗？
四级多少分通过	四级多少分通过
完形填空、听力	四级考试题型
英语听力练习	提高英语听力的方法
英语四级考试题型	不检索
菏泽的历史	不检索
菏泽市名由来	菏泽市名由来
菏泽市历史	菏泽历史
菏泽经济发展的原因	不检索
中原地区范围	中原地区范围
中原地区的范围	不检索
冬天吃火锅	冬天吃火锅
火锅的种类	火锅的种类
九宫格火锅	九宫格火锅
火锅的起源	火锅的起源
火锅的起源	不检索
火锅加什么	吃火锅的食品
广东省佛山市天气	广东省佛山市天气
佛山天气	雨天能干的事情
下雨天阴阴的心情会很不好	雨天阴阴的心情会很不好
下雨天的注意事项	不检索
下雨天在家做什么	不检索
胃疼的原因	不检索
学医的好处	学医
医生的培养年限	不检索
博士和研究生的区别	不检索
实习	不检索
毛不易	毛不易歌
毛不易出道	毛不易出道
明日之子	明日之子出道
周震南	周震南
周震南	不检索
小狗狗	养狗
养狗的品种	宠物狗
柯基是什么性格的狗狗	柯基
带柯基出门	不检索
养狗的注意事项	不检索
养狗需要准备的东西	不检索
科比	科比坠机
科比坠机	科比曼巴精神
科比	库里
库里	不检索
库里	不检索
四川广安的商场	不检索
床和衣柜	不检索
智能家居	智能家居
智能家居	智能家居产品
智能家居	不检索
德牧的花销	德牧花费
河南平顶山养狗	不检索
平顶山禁养犬	不检索
养德牧的好处	不检索
平顶山宠物商店	平顶山领养动物
平顶山领养动物	不检索
泛娱乐	泛娱乐
粉丝经济	粉丝经济
喜欢的明星	不检索
脑残粉	不检索
张杰脑残粉	不检索
抖音总刷到公交车上爆炸电视剧	不检索
开端男主角	电视剧开端
开端电视剧	电视剧开端
开端电视剧	哪里可以看到开端电视剧
腾讯视频弹幕	不检索
吊兰	养吊兰的好处
养吊兰的技巧	养吊兰的技巧
养吊兰的注意事项	养花的好处
养花的好处	不检索
养宠物的好处	不检索
我是歌手歌手	我是歌手
邓紫棋	邓紫棋
邓紫棋的歌	邓紫棋歌曲
邓紫棋演唱会	邓紫棋演唱会
邓紫棋微博账号	邓紫棋微博账号
薯片的好处	不检索
青柠口味的薯片	薯片口味
咸蛋黄薯片	咸蛋黄薯片牌子
乐事薯片	乐事薯片
上好佳薯片	上好佳
名著小说	不检索
月考差的原因	不检索
名著	中学生课外名著
射雕英雄传	射雕英雄传
射雕英雄传	金庸作品
体育赛事	体育赛事
体育比赛	不检索
乒乓球	不检索
冰上乒乓球	不检索
东奥会冰上乒乓球	东奥会乒乓球比赛
羽生结弦	不检索
贾平凹	贾平凹
贾平凹的小说	贾平凹
白鹿原作家	陈忠实作家
陕西作家	陕西作家
路遥	路遥
周杰伦的歌	不检索
周杰伦	中国歌手
周杰伦的歌	双截棍
双截棍歌曲	双截棍的歌曲种类
周杰伦的歌	不检索
沃柑	沃柑
沃柑	沃柑和皇帝柑一样吗
凤梨和菠萝的区别	凤梨和菠萝一样吗
都乐菠萝	都乐菠萝
凤梨和菠萝的区别	不检索
蛇	不检索
小蛇蛇	不检索
适合养的宠物蛇	适合养的宠物蛇品种。
猪鼻蛇	养猪鼻蛇的注意事项。
养蛇的注意事项	不检索
狼人杀	不检索
狼人杀	不检索
狼人杀	不检索
狼人杀	不检索
狼人杀	不检索
作家的作品	不检索
张爱玲	张爱玲
张爱玲的作品	张爱玲作品
第一炉香	不检索
马思纯	不检索
小仓鼠	不检索
小仓鼠怎么养	小仓鼠怎么养
小仓鼠的注意事项	养小仓鼠的注意事项
小仓鼠怎么养	不检索
小仓鼠的寿命	小仓鼠的寿命
元宵节的快乐	不检索
元宵节诗歌	不检索
元宵节诗歌	元宵节诗歌
学欧阳修的诗	生查子元夕
扬州景点	不检索
谁是歌手	我是歌手
《我是歌手》	《我是歌手》
我是歌手冠军	我是歌手冠军
张杰	张杰
张杰	不检索
听歌的好处	不检索
欧美的歌	欧美的歌曲
迈克尔.杰克逊	迈克尔.杰克逊
迈克尔.杰克逊	不检索
贾斯丁比伯	贾斯丁比伯
贾斯丁比伯的歌	贾斯丁比伯的歌
纸币的生产成本	纸币生产成本
纸币防伪	一元纸币有防伪吗
uv油墨	uv油墨
纸币防伪油墨	纸币防伪油墨
纸币的防伪油墨	不检索
屯门疫情	屯门深圳湾口岸路线
香港疫情	香港国安法出台
香港国安法出台后，中央政府就能直接参与管理	一国两制香港体制
香港的发展从什么时候开始的？	不检索
香港国安法出台后，香港的经济环境发生了根本性的	不检索
日本动漫	不检索
新番推荐	不检索
小林家的龙女仆2	小林家的龙女仆
日本动漫流行的原因	日本动漫流行的原因
日本动漫的衍生品	不检索
衡水市天气	河北省衡水市天气
电视剧	不检索
拆弹专家2	不检索
刘德华	刘德华
刘德华	刘德华电影
《拆弹专家2》	不检索
哪个牌子的手机质量好	哪个品牌的手机质量好
华为mate8	质量好的华为手机
华为mate10颜色	华为mate10的颜色
在网上买手机安全吗	在网络上买手机安全吗
华为mate10怎么样	不检索
北京寒假	北京寒假天气
北京冬季天气	不检索
北京的景点	不检索
颐和园	不检索
滑雪场	不检索
疫情期间在家待久的原因	不检索
疫情期间相处的时间	不检索
在家干嘛	不检索
和家人住在一起	不检索
什么样的家庭才是美满的	什么样的家庭才是美满的
体运动	不检索
篮球和足球哪个好玩	篮球和足球哪个好玩
nba球星	科比
科比和乔丹哪个更厉害	不检索
科比	不检索
苏炳添	苏炳添
苏炳添	不检索
苏炳添	苏炳添
苏炳添	不检索
苏炳添	不检索
跑步的好处	不检索
元宇宙	现代元宇宙概念
元宇宙	元宇宙技术现状
元宇宙宣传	不检索
模拟人生	不检索
鱼缸中之脑	不检索
历史专业的学生	边疆史是什么
史学家	史学家有哪些
《史记》的意义	考研是什么
考研的专业	不检索
考研和朋友约局的原因	不检索
水果的好处	水果
柚子的好处	柚子
香蕉的好处	不检索
香蕉的好处	不检索
篮球场	不检索
篮球场	不检索
韩红	韩红的成名曲
韩红公益	韩红公益
韩红公益	不检索
韩红的歌	不检索
韩红的歌	不检索
养猫的好处	不检索
西电宿舍	不检索
西电猫	英短
英短	英短性格
拈酸吃醋猫	不检索
面朝大海，春暖花开。	不检索
面朝大海，春暖花开	面朝大海，春暖花开
海子的诗	海子的简介
面朝大海春暖花开	面朝大海春暖花开的含义
面朝大海春暖花开	不检索
面朝大海春暖花开	不检索
出圈的游泳运动员	出圈是什么意思
傅园慧	傅园慧
傅园慧的微信公众号	不检索
傅园慧	不检索
傅园慧退役	不检索
傅园慧退役	傅园慧退役
电视剧开端	电视剧开端
刘涛的演技怎么样	演员刘涛
刘涛演的白娘子	不检索
电视剧	演员高圆圆
《倚天屠龙记》	电视剧完美伴侣
沈腾	含腾量
沈腾	不检索
魏翔	魏翔
魏翔	不检索
魏翔	魏翔年龄
和女朋友在一起一周年纪念日应该怎么过	不检索
上海的景点	不检索
上海迪士尼攻略	上海迪士尼攻略
在迪士尼谈恋爱	不检索
送女友的礼物	玲娜贝儿
玲娜贝儿	不检索
哈利波特电影	哈利波特上映时间
指环王上映时间	指环王上映时间
哈利波特	哈利波特
哈利波特	哈利波特
哈利波特电影	不检索
历史上真的有甄嬛这个人吗？	熹妃
乾隆是谁生的	不检索
雍正和雍正是同母异父的吗	雍正和乌拉纳喇氏
乌拉那拉氏	不检索
乌拉那拉氏	不检索
养花的好处	养花的意义
容易成活的花	哪些花比较好养活
小苍兰	小苍兰
小苍兰	小苍兰的花语
小苍兰的寓意	如何养花
老师压力	不检索
老师的职业	老师
教师资格证	教师资格证
教师资格证考试内容	教师资格证考试内容
教师资格证考试	不检索
对外汉语专业	不检索
对外汉语专业就业前景	不检索
上海经济类专业	不检索
对外汉语专业在哪个学校比较好	不检索
对外汉语专业的就业方向	不检索
春招	春招
春招岗位	如何准备春招
面试紧张	面试紧张怎么办
面试紧张	不检索
面试紧张	不检索
柑橘的好处	不检索
柑橘的好处	吃柑橘的好处
柑橘的好处	不检索
柑橘怎么能消除疲劳	柑橘为什么能消除疲劳
橘子为什么能解夏日疲劳	不检索
枸杞茶	不检索
养生的方法	养生方法
程序猿	不检索
办公室养生小妙招	不检索
办公室养生	不检索
日本动漫	日本动漫的发展过程大致可分为4个阶段
日本动漫题材	日本动漫题材
日本动漫三次高潮	日本动漫三次高潮
日本动漫三次革命	日本动漫三次革命
日本动漫的体系	日本动漫工作者协会
日本动漫工作者协会	不检索
最给国家争光的运动	不检索
中国女排	中国女排
朱婷	中国女排
中国女排	不检索
朱婷	朱婷
西藏旅行	西藏旅行景点
布达拉宫	布达拉宫
布达拉宫	布达拉宫的旅游路线
布达拉宫景点	不检索
西藏美食	西藏美食
火车上的景色	不检索
东北的火车路线	吉图珲高铁现在有什么车次
吉图珲高铁	不检索
高铁到沈阳转车	k1449经停各站
吉图珲高铁	不检索
手机头像	不检索
单反的优点	单反相机经典款
单反的优点	不检索
手机和单反的区别	手机人像摄影
拍照的技巧	不检索
经常流鼻涕是不是鼻炎	经常流鼻涕是不是鼻炎
慢性鼻炎	一感冒就头疼是鼻炎吗
风一吹就头痛	风一吹就头痛是怎么回事
冬天出门戴帽子	不检索
冬天的帽子	不检索
冬天的帽子	不检索
情人节是什么时候过的	不检索
情人节	狮子座男生缺点
喜欢狮子男	不检索
爱你的人	不检索
失恋的原因	不检索
为什么不和他在一起了	彻底分手
东京奥运会	东京奥运会延期
东京奥运会	东京奥运会的开幕式
2008年北京奥运会	东京奥运会的比赛项目
东京奥运会的比赛项目	东京奥运会的精彩瞬间
东京奥运会开幕式	奥地利女将安娜基森霍夫怎么一个人去参加奥运会
日本女将安娜基森霍夫	不检索
玩游戏的好处	手机游戏
和平精英	王者荣耀
和平精英	不检索
和平精英	不检索
吃鸡游戏	和平精英
和平精英和王者荣耀哪个好上手	不检索
北京站到故宫	北京站到故宫公共交通
北京公交可以用现金吗	北京公交app
手机内存不足	不检索
北京公交app	不检索
北京公交app	不检索
广西壮族自治区的景点	广西热门景点
八寨沟	八寨沟
八寨沟景点	八寨沟旅游
八寨沟门票	八寨沟旅游花销
八寨沟旅游费用	八寨沟旅游费用
八寨沟景点	不检索
多肉	养多肉
多肉养花	不检索
昙花	昙花怎么吃
昙花的营养价值	不检索
月桂	不检索
清明假期去哪里玩	旅游清明
莽山	不检索
莽山	莽山
清明假期时间	清明节假期
清明假期去哪里玩	不检索
吃零食的好处	良品铺子的零食
良品铺子松饼	不检索
好吃的零食	三只松鼠小零食
三只松鼠	不检索
三只松鼠零食	不检索
新余市海边的图书馆	不检索
国内的图书馆	国内藏书最多的图书馆
新余市图书馆	新余市最大的图书馆
新余市的大型图书馆	中国最美的图书馆
北京国家图书馆	不检索
国家图书馆	不检索
化妆品品牌。	不检索
化妆品推荐	不检索
口红推荐	口红品牌推荐
ysl色号	ysl口红色号推荐
郑州市天猫旗舰店	不检索
大学生有必要买电脑吗	大学生有必要买电脑吗
mac系统的电脑	苹果电脑系统
苹果机	不检索
苹果电脑生态	买苹果电脑最好有苹果手机
苹果电脑系统	不检索
炒股的好处	炒股的介绍
涨跌	股票涨跌指什么
如何了解市场	小白怎么开始炒股
新手如何开始炒股	不检索
新手如何开始炒股	不检索
顾城	顾城
顾城	顾城
顾城	海子
海子的诗	面向大海，春暖花开
面朝大海春暖花开	不检索
杨丽萍	不检索
杨丽萍的舞	杨丽萍跳什么舞最出名
杨丽萍跳的什么舞最出名	不检索
杨丽萍	杨丽萍多少岁
杨丽萍的舞蹈	不检索
好吃的美食	美食
煎饼	煎饼种类
山东煎饼	山东煎饼
山东煎饼的营养价值	不检索
山东煎饼	不检索
名著推荐	四大名著
红楼梦作者	红楼梦作者
红楼梦结局	红楼梦
红楼梦人物	红楼梦人物
红楼梦人物	不检索
中国风	中国风
中国风音乐	中国风音乐
中国民乐	中国民乐
中国风的音乐	不检索
中国风歌手	不检索
区块链	不检索
区块链	区块链
区块链学习	不检索
区块链的发展成果	区块链的发展成果
区块链的应用	不检索
教师资格证科目	教师资格证
教师资格证考试科目	教师资格证的科目
教师的职业	教师
成为教师需要具备什么条件	教师素质
机器人会取代教师吗	教师的不可替代性
教师的未来	不检索
国外旅行	不检索
东南亚旅行	东南亚旅行
什么时候去比较合适	东南亚旅行时间推荐
冬季防晒	不检索
东南亚蚊虫	不检索
水逆	不检索
3月19日是什么星座	3月19日的生日是什么星座
双鱼座	双鱼座最近运势
双鱼座最近运势	不检索
双鱼座最近运势	不检索
元宇宙	元宇宙
元宇宙	不检索
元宇宙	元宇宙的应用
元宇宙的定义	不检索
碎片化利用时间	如何碎片化利用时间
张家界景点	不检索
湖南景点	湖南景点
湖南美食	湖南美食
橘子洲	橘子洲烟花
橘子洲烟花	不检索
吃烧烤的好处	不检索
家常菜	家常菜
川菜	辣椒酱
辣椒酱	不检索
奶茶	不检索
河源美食	早茶品种
煲仔饭	广东的美食
肠粉	肠粉
河源美食	广东天气
广东夏天热	不检索
养生的重要性	养生的重要性
菊花茶	花茶
花茶的好处	不检索
养生的好处	不检索
kfc	不检索
看电影的好处	不检索
电影	不检索
漫威电影	漫威电影
《钢铁侠》	钢铁侠
《钢铁侠》	不检索
南阳景点	南阳市景点
卧龙岗	卧龙岗
水帘洞	南阳水帘洞
南阳美食	南阳美食
南阳蒸菜	不检索
雪中悍刀行	雪中悍刀行
雪中悍刀行张若昀	张若昀
张若昀庆余年	不检索
张若昀的性格	不检索
张若昀的庆余年2和雪中悍刀行2	不检索
张若昀的无心法师	不检索
今天天气	今日天气
汉中天气	不检索
陪伴家人的方法	增进与家人感情的方法
吃饭看手机的危害	吃饭看手机的危害
吃西餐的好处	附近商场
中医的作用	中医
针灸的好处	针灸
针灸的作用	不检索
中医的优点	不检索
中医的优点	不检索
中医的优点	不检索
熬夜的危害	熬夜的危害
熬夜的危害	熬夜危害
熬夜的危害	助眠的方法
热水澡的好处	热水澡的好处
热水澡的好处	不检索
外国人用中文辩论	不检索
世界青年说	不检索
学汉语的专业	不检索
对外汉语	对外汉语
国际教育专业出国	汉语国际教育专业出国
国际汉语教师资格证	国际汉语教师资格证
水浒传好汉	鲁智深
武松打虎	武松打虎
沈璟	汤显祖
汤显祖	《牡丹亭》
牡丹亭	不检索
拉萨	拉萨
拉萨的景点	不检索
拉萨美食	拉萨美食
拉萨美食	拉萨美食
拉萨的美食	不检索
毕业后从事什么工作？	不检索
找工作	找工作的网站
面试注意事项	面试注意事项
面试注意事项	不检索
面试小白	不检索
最近的天气	天气异常
河南暴雨	河南暴雨
河南为什么水排不走	不检索
黄河为什么不能进黄河	不检索
河南的人祸	不检索
星座	不检索
白羊座今日运势	白羊座近期运势
白羊座幸运色	白羊座的幸运色
紫色卫衣和白色的运动鞋	不检索
白羊座的幸运色	不检索
钓鱼装备	钓鱼装备
钓鱼基础装备	不检索
北京钓鱼	北京钓场
北京钓鱼	不检索
钓鱼前要做什么准备	不检索
西安寒假天气	不检索
西安景点	西安景点
西安博物院	西安博物院
西安博物院门票	不检索
美团预约	不检索
谷爱凌	谷爱凌
谷爱凌	不检索
自由滑雪	自由式滑雪
冬奥会项目	自由式滑雪
花样滑冰	花样滑冰
嘉峪关景点	不检索
嘉峪关	关于嘉峪关的诗句
嘉峪关景点	不检索
附近的著名景点	附近的景点
嘉峪关长城	敦煌莫高窟
红烧肉的做法	不检索
红烧肉	红烧肉技巧
红烧肉怎么做	不检索
红烧肉为什么用香叶	不检索
阿拉尔市天气	阿拉尔市天气
红烧肉的营养价值	不检索
胃疼的原因	胃疼
胃病原因	胃病原因
早上吃什么	不检索
胃病吃什么	不检索
吃烧烤的危害	不检索
北京四中的美食	不检索
酸辣粉	酸辣粉起源于哪里
油条	油条诞生于哪里
油条的起源	不检索
油条的历史	不检索
超市的零食	不检索
看电视的零食	看电视吃的零食
薯片牌子	不检索
薯片除了乐事和可比克还有啥牌子	薯片牌子
上好佳薯片	不检索
星座可信吗	不检索
处女座和金牛座的爱情	处女男和金牛女配吗
处女座和金牛座配对指数100%	不检索
处女座性格	处女座性格
处女座的人都追求完美	处女座特点
脸上长斑的原因	不检索
祛斑化妆品推荐	祛斑化妆品
雅漾美白祛斑乳	不检索
雅漾美白祛斑乳	化妆品推荐
雅漾美白祛斑乳	不检索
代码是什么	不检索
清华大学代码	清华大学代码
中山大学代码	中山大学代码
上海交通大学代码	上海交通大学代码
代码的重要性	不检索
熬夜的危害	熬夜的坏处
熬夜的危害	早睡早起的时间段
早睡的好处	早睡可以养生吗？
器官工作	器官排毒的工作时间
养生的方法	养生的方法
养生的方法	不检索
牙膏推荐	如何推荐牙膏
牙齿敏感牙膏	敏感牙齿牙膏
牙膏推荐	牙齿敏感牙膏
牙齿敏感牙膏	牙齿敏感牙膏
牙齿敏感牙膏	不检索
腾讯公司	不检索
互联网行业	互联网传媒
互联网是什么时候开始有的	最早的互联网
现在的互联网	不检索
互联网专业	互联网专业
西宁天气	青海近15天温度
西宁旅游	云南的温度
云南旅游	云南景点
西宁到西宁机票	青海到昆明机票多少钱
西宁到昆明机票多少钱	不检索
牙根疼	牙根疼原因
牙疼原因	不检索
刷牙牙龈出血	刷牙牙龈出血
刷牙正确的刷法	刷牙正确的刷法
刷牙的正确方法	不检索
《犬夜叉》	不检索
杀生丸	杀生丸
犬夜叉和桔梗	戈薇
戈薇	不检索
柯南	不检索
好吃的零食	乐事新口味
乐事新口味薯片	不检索
乐事新口味薯片	乐事新口味薯片
乐事新口味薯片	不检索
乐事新口味薯片	不检索
河图的歌	不检索
河图	河图的最新歌曲
倾尽天下	倾尽天下年份
河图	河图哪里人
沅陵景点	湖南沅陵景色
当一个老师需要什么	当一个老师需要什么
教师资格证考什么	教师资格证考什么呀，什么时候考
普通话等级证	普通话等级证
普通话等级证	不检索
教师的责任	教师
活着电影	活着电影
活着主演	活着主演
葛优	葛优
葛优	葛优
葛优	葛优
林丹是什么时候开始打羽毛球的	林丹学习羽毛球
林丹参加的比赛	林丹第一次参加比赛
林丹	林丹
林李大战	林李大战
林丹	不检索
卡粉的原因	不检索
粉底液推荐	不卡粉的粉底液
ysl逆龄粉底液价格	ysl逆龄粉底液价格
ysl逆龄粉底液价格	不检索
雅诗兰黛和ysld的区别	不检索
我心永恒电影	我心永恒
泰坦尼克号主题曲	不检索
泰坦尼克号	泰坦尼克号电影
泰坦尼克号	泰坦尼克号
泰坦尼克号泰坦尼克号	泰坦尼克号
四川资阳房价	四川资阳房价
买房的时间。	买房贷款
雁江区房价	资阳雁江区房价
资阳雁江区房价	买房软件
资阳明天天气	资阳明天天气
嗓子疼	不检索
嗓子疼的原因	不检索
莲花清瘟	莲花清瘟
莲花清瘟吃多少	不检索
莲花清瘟	不检索
辣条的好处	辣条牌子
卫龙	飞旺辣条产品
零食推荐	素肉推荐
甜口零食	不检索
稻香村	稻香村产品
过年吃什么水果	不检索
手剥黄的水果	多吃橘子脸会变黄么
橘子吃多了会发黄怎么办	橘子吃多了脸发黄怎么缓解
黄脸婆	吃沙糖桔的好处
橘子的香气	不检索
流行音乐	不检索
崔健	崔健
五月天演唱会	生命无限公司演唱会
《人生无限公司》	音乐类电影
《放牛班的春天》	何勇钟鼓楼
消愁	消愁
毛不易	毛不易
毛不易	毛不易
毛不易	毛不易
毛不易的歌	不检索
2021年新上映的电影	不检索
新蝙蝠侠	不检索
新电影《少年有你》	不检索
《新蝙蝠侠》	不检索
美国电影《新蝙蝠侠》	不检索
父母的性格	不检索
父母结婚	家庭
三亚景点	三亚
三亚海边	不检索
三亚海边	不检索
山东威海	不检索
庐山瀑布	不检索
庐山瀑布	庐山瀑布
李白	李白
李白的诗	将进酒
天生我才必有用，千金散尽还复来。	李白的诗
今年的考研时间。	今年的考研时间今年的考研时间
考研时间	不检索
考研英语怎么学习	怎么学习考研英语怎么学习考研英语
考研英语课	不检索
考研英语怎么学习	不检索
相信占卜吗	你相信占卜吗
宝藏博主	不检索
占卜的好处	不检索
星座和占卜的区别	占卜和看星座的区别
占卜的意义	不检索
薛之谦的歌	薛之谦
薛之谦的歌	不检索
《演员》	《演员》
薛之谦音乐节	音乐节
薛之谦音乐节	不检索
薛之谦	不检索
出国旅游	塔希提
《月亮与六便士》塔希提	不检索
塔希提机票贵吗	北京去塔大溪地
去塔希提的机票	不检索
年假申请	不检索
牙膏的危害	不检索
早上牙膏用完	不检索
牙膏品牌	不检索
纳爱斯牙牙乐儿童营养牙膏	纳爱斯牙牙乐儿童营养牙膏
纳爱斯牙膏	不检索
异宠	异宠
异宠	异宠
异宠	不检索
异宠	蛇难养吗
异宠	异宠
鞠婧祎	鞠婧祎
鞠婧祎长相	不检索
鞠婧祎演的电视剧	鞠婧祎的演技怎么样
鞠婧祎的粉丝	不检索
鞠婧祎的粉丝	不检索
初学摄影的朋友可以买什么相机	不检索
摄影好学吗	摄影
拍人物和静物的技巧	不检索
单反和微单	单反和微单
尼康相机	相机品牌
尼康尼康相机价格	不检索
尼康尼康相机价格	不检索
被蚊子咬伤	不检索
六神花露水	六神花露水
六神花露水	六神花露水
六神花露水的功效	六神花露水效果
六神花露水	不检索
2022年综艺	最近综艺
程璐思文离婚	程璐思文离婚
亲爱的，不爱的节目	综艺节目亲爱的，不爱的
秦昊去年的爬山吗？	不检索
秦昊和伊能静的演技	不检索
开心消消乐	不检索
开心消消乐	开心消消乐
开心消消乐一共有多少小动物	开心消消乐动物种类
开心消消乐的游戏方式	开心消消乐
开心消消乐	不检索
汤加火山喷发	汤加海底火山喷发
汤加	汤加的简介
汤加语言	汤加语
汤加喷发	不检索
海啸	不检索
保护汤加	不检索
中国出的动漫	国漫
一人之下的中国元素	《一人之下》
陈朵篇	不检索
王也	不检索
王也	不检索
王也	不检索
烟台景点	烟台景点
蓬莱阁	蓬莱阁
烟台天气	天气
北京环球影城	北京环球影城交通
北京环球影城门票	北京环球影城门票
洗洁精有毒吗	洗洁精有毒吗
表面活性剂温和吗	洗洁精表面活性剂有温和的吗
阳离子表面活性剂	阳离子表面活性剂用途
洗洁精原理	表面活性剂原理
洗洁精表面活性剂	不检索
荔枝是什么月份的水果	荔枝是几月份的水果荔枝是几月份的水果
荔枝的季节	不检索
芒果怎么挑	芒果怎么挑
芒果怎么挑	不检索
怎么挑水果	不检索
石黑一雄	石黑一雄
东野圭吾	挪威的森林
挪威的森林电影	挪威的森林电影
大兴安岭的森林	挪威纬度
大兴安岭纬度	不检索
肥宅快乐水	不检索
可乐是什么时候发明的	可乐是什么时候发明的
可乐是当药喝的吗	不检索
可口可乐是什么时候有的	可口可乐公司成立
可口可乐是什么时候有的	圣诞老人可口可乐
圣诞老人	可乐第二次世界大战
开端电视剧	开端电视剧
《小敏家》	周迅影视作品
生活类电视剧	生活类电视剧
生活类电视剧	山东的景点
泰山	不检索
中医的好处	不检索
中医药大学	中医药大学排名
古代名医	古代名医
华佗典故	华佗典故
华佗的典故	不检索
关于下棋的电视剧	关于下棋的电视剧
棋魂主演	棋魂主演
胡先煦	胡先煦
百鸟朝凤	百鸟朝凤电影
张小宇百鸟朝凤	不检索
疫情周末	不检索
张爱玲	不检索
张爱玲	张爱玲
张爱玲的第一炉香	第一炉香电影影评
东野圭吾	不检索
摆臂的好处	跑步摆臂节奏
摆臂紧张怎么办	不检索
跑步呼吸节奏	长跑呼吸节奏
跑步的心率	不检索
吸气的时候可以通过嘴巴吗	跑步可以用口吸气吗
海马能长个子吗	海马长个子
海马价格	海马价格
海马的营养价值	不检索
智商税	不检索
连花清瘟	不检索
最近火的歌	热门歌曲
《起风了》	起风了歌曲
吴青峰的歌	吴青峰歌
我好想你	不检索
最近的新乐队	大大大大大象
养宠物的好处	不检索
猫的优点	不检索
流浪猫	不检索
宠物猫的品种	猫的品种
布偶猫价格	布偶猫价格
富婆养宠物	不检索
陈奕迅的歌	孤勇者，陈奕迅
站在光里的陈奕迅	陈奕迅的十年
陈奕迅十年	不检索
富士山下	不检索
富士山下	不检索
家里养花的好处	阳台养花
阳台养花	阳台养花
不同品种的花需要的阳光水分	长寿花喜
阳台养花需要的肥料	花肥
阳台养花的好处	不检索
种向日葵游戏	不检索
种向日葵游戏	不检索
植物大战僵尸	植物大战僵尸
植物大战僵尸	不检索
植物大战僵尸	植物大战僵尸
最百搭鞋子	最百搭鞋子
小白鞋	不检索
穿什么衣服搭小白鞋	小白鞋搭配
小白鞋搭配阔腿裤	不检索
腿短的人穿阔腿裤会显矮吗	不检索
济南市景点	济南市景点
济南市景点	济南市景点
济南市景点	济南市景点
济南市景点	济南市景点
济南市景点	不检索
手机的品牌。	iphone13
苹果13价格	不检索
年货节	不检索
拼多多	拼多多百亿补贴
拼多多手机	拼多多买手机
拼多多年货节	不检索
小红书恋爱	小红书恋爱
谈恋爱的坏处	不检索
春娇与志明	春娇与志明
张志明	张志明余文乐经典台词
余文乐结婚	不检索
余文乐	不检索
王蒙解说	王蒙滑冰
王蒙滑冰	王蒙滑冰
东北冰雪运动员	不检索
东北冬季滑雪	不检索
室内冰场	吕梁冰场
浪漫的诗句	不检索
看电影烤红薯板栗冰糖葫芦和你	甘肃庆阳天气
庆阳市天气	不检索
开心麻花喜剧电影	开心麻花的喜剧电影
开心麻花的喜剧电影	不检索
电影	不检索
你好李焕英	你好李焕英的电影
贾玲	贾玲
贾玲	沈腾
沈腾	不检索
张若昀	张若昀
张若昀	《麻雀》中的张若昀的演技怎么样
张若昀的电视剧	张若昀的电视剧
法医秦明	《法医秦明》中的张若昀演技
张若昀和唐艺昕的爱情	张若昀和唐艺昕的爱情
张若昀演的电视剧	不检索
香港茶餐厅	不检索
酸酸辣辣豚骨面	酸酸辣辣豚骨面
酸酸辣辣豚骨面	不检索
煲仔饭做法	不检索
煲仔饭排骨腊肠	煲仔饭排骨腊肠
煲仔饭做法	不检索
特殊年是什么年	2021年为什么特殊
《觉醒年代》的意义	《觉醒年代》的影响
开天辟地的大事变	开天辟地的大事变
陕西安康红色革命纪念地	不检索
红色革命纪念馆	石泉县红色革命纪念馆
石泉县红色革命纪念馆	不检索
玫瑰好养吗	种植玫瑰
多头玫瑰	多头玫瑰
养花的好处	干花
玫瑰干花	不检索
鲜花店	不检索
鲜花店老板娘	不检索
密室逃脱	密室逃脱怎么玩
团建密室逃脱	不检索
吉吉县城附近的密室逃脱店	江西吉安玩密室逃脱的地址
x.d密室逃脱	不检索
团建必备项目	不检索
跳舞的好处	爵士舞
孔雀舞	孔雀舞
舞种	舞种
舞种	舞种
中国古典舞	不检索
济南市天气	成都晴天
成都明天天气	不检索
成都疫情	成都疫情
成都疫情	不检索
成都近期天气	不检索
榴莲的营养价值	榴莲的好处
榴莲的营养价值	榴莲很贵吗
榴莲的好处	不检索
草莓的好处	草莓的好处
吃水果的好处	不检索
香蕉的好处	香蕉的好处
椰子的好处	椰子的营养价值
椰宝	椰宝
椰子的季节	椰子哪个季节有
开椰子的方法	不检索
椰子的品种	椰子的品种
彭于晏	彭于晏作品
唐钰小宝	唐钰小宝
唐钰小宝是阿奴的经典台词	不检索
胡歌	胡歌
胡歌	不检索
疫情	不检索
海南海边	海南旅行
三亚海边	海南旅游
椰子鸡	海南椰子鸡
海南美食	不检索
冬天吃什么水果	冬天吃什么水果
苹果的好处	苹果的营养价值
苹果的营养价值	苹果派
苹果派	苹果派
烤箱苹果派	不检索
中药可以治痔疮吗？	中医能够v痔疮吗？
痔疮吃什么药	治痔疮的中药。
化痔栓吃多久	化痔栓
痔疮吃什么药	不检索
痔疮吃什么药	不检索
今天天气	天气
咸宁景点	附近娱乐
咸宁景点	附近景点
咸宁温泉谷度假区	咸宁温泉谷度假区
咸宁温泉谷度假区	不检索
北京到北京的火车	不检索
北京到无锡的火车	从无锡到北京坐高铁需要多久多少钱
无锡到北京飞机	从无锡到北京飞机用时
从无锡到北京直飞多少钱	不检索
无锡到北京机票多少钱	不检索
区块链	区块链
区块链	区块链为什么突然火了
区块链公司	不检索
大学生如何学习区块链	不检索
博士装逼	不检索
长沙今天天气	长沙今天天气
长沙天气	不检索
胡歌	胡歌电视剧
胡歌琅琊榜	胡歌琅琊榜
胡歌	不检索
苏炳添	不检索
苏炳添	苏炳添
983大学	不检索
如何跑得更快	如何跑得更快
跑步的好处	不检索
健康零食	健康小零食
坚果盐焗腰果	坚果怎么吃才健康
奶香夏威夷果	不检索
健康零食	黑芝麻蜂蜜饼
养养洗发水	不检索
河南景点	河南景点
清明上河园	清明上河园的位置
清明上河园	不检索
清明上河园距离	濮阳市离清明上河园有多远
清明上河园	不检索
跑步的好处	跑步练习
跑步压力	跑步压力
跑步的方法	800米跑步
变速跑	变速跑
跑步换气	跑步换气
跑步换气	不检索
迪士尼	不检索
法国版的《沉睡魔咒》	《沉睡魔咒》
《沉睡魔咒2》	《沉睡魔咒2》
《他是龙》	《他是龙》
《他是龙》	不检索
《他是龙》	不检索
养狗的好处	不检索
阿拉斯加狗	阿拉斯加犬
养狗的好处	湖北省十堰市禁养犬名单
湖北省十堰市禁养犬	狗证
养狗的好处	不检索
养花的好处	不检索
多肉的好处	多肉植物好养么？
多肉的品种	多肉好养的品种
多肉的名字	不检索
多肉长的高	多肉长的过高是为什么
多肉的养护	不检索
最火的游戏	最火的游戏
王者荣耀	王者荣耀
王者荣耀怎么玩	王者荣耀
王者荣耀	王者荣耀怎么玩
王者荣耀技巧	王者荣耀技巧
羊羔绒的穿搭	不检索
羊羔绒大衣搭配	羊羔绒大衣怎么搭配？
羊羔绒大衣搭配马丁靴	不检索
羊羔绒外套品牌	羊羔绒外套，推荐品牌。
羊羔绒大衣	不检索
小时代	《小时代》
郭敬明电影	《小时代》电影
郭敬明的作品	郭敬明的作品
郭敬明作品	郭敬明杂志
郭敬明的作品	不检索
楚雄旅游	旅游
出国旅游	不检索
日本旅游	去日本旅游
护照	护照
护照	不检索
护照	不检索
《动物农场》	《动物农场》
《动物农场》	不检索
猪的脸和人的脸模糊不清的时候，鸡皮疙瘩	不检索
《美丽新世界》	《美丽新世界》
《美丽新世界》	不检索
德雷尔一家	《德雷尔一家》
神农架林美食	湖北神农架美食
懒豆腐	不检索
山西美食	山西美食
腊肉	腊肉做法
腊肉做法	不检索
胡歌琅琊榜	胡歌琅琊榜
梅长苏	梅长苏
胡歌	胡歌的品质
仙剑奇侠传三胡歌	胡歌仙剑奇侠传三
胡歌的电视剧	胡歌
胡歌的电视剧	不检索
扬州天气	宅家有什么好玩的游戏
木头人游戏	木头人游戏怎么玩
木头人游戏	不检索
自制甜点	简单易做的甜点有哪些
芒果糯米滋	不检索
《流浪地球》	电影《流浪地球》
吴京的电影	吴京的电影
魔童	《魔童降世》
《爱情神话》	《爱情神话》
《流浪地球》的配色	不检索
《你好李焕英》	《你好李焕英》
圣女果	圣女果
水果	榴莲
榴莲雪糕	不检索
荔枝	荔枝
吃榴莲的危害	不检索
化妆的化妆品	化妆的必备物品
化妆的花销	不检索
唇彩	唇彩流行品牌
腮红推荐	腮红流行的品牌
西安天气	附近购物中心
云南省临沧市天气	不检索
《飘》	《飘》
斯嘉丽的性格	不检索
艾希礼	乱世佳人
斯嘉丽	不检索
《乱世佳人》	不检索
什么时候可以脱单	谈恋爱
谈恋爱的好处	高质量的单身生活
如何拥有高质量单身生活	不检索
谈恋爱需要注意什么	谈恋爱需要注意什么
谈恋爱需要注意什么	不检索
今天天气	今天的天气
买羽绒服的注意事项	不检索
挑选羽绒服的方法	怎么挑选羽绒服
挑选羽绒服的方法	不检索
冬季保暖的商场	不检索
贵州省贵阳市天气	不检索
贵州电影	附近电影院
贵州天气	不检索
赵丽颖电视剧	赵丽颖电视剧
赵丽颖的电视剧	不检索
河南省济源市天气	河南省济源市天气
斗罗大陆	不检索
唐家三少	唐家三少的小说有哪些
斗罗大陆	斗罗大陆
斗罗大陆	不检索
区块链	不检索
区块链是什么	不检索
区块链的应用	区块链的应用
区块链技术	不检索
区块链技术	不检索
陈奕迅演唱会	不检索
陈奕迅演唱会	不检索
陈奕迅的歌	陈奕迅的歌
陈奕迅的歌	陈奕迅k歌歌单
陈奕迅的歌	不检索
甄嬛传	不检索
甄嬛传	甄嬛传火
甄嬛传第一遍忽视了什么	不检索
眉庄	眉庄优点
眉庄	不检索
粉蒸肉	粉蒸肉
粉蒸肉做法	粉蒸肉材料
粉蒸肉做法	粉蒸肉做法
粉蒸肉做法	不检索
粉蒸肉做法	粉蒸肉耗时
粉蒸肉做法	不检索
巴比伦塔	巴比伦塔建成时间
巴比伦塔建造时间	巴比伦塔建造时间
巴比伦塔	巴比伦塔建造时间
巴别塔建成时间	巴别塔在哪
巴比伦塔	不检索
零食	看电影零食
肥宅快乐水	不检索
肥宅快乐水	好吃的零食
网红零食	不检索
宅家零食	不检索
吃什么都撑	不检索
吃石锅拌饭的危害	不检索
吃零食的危害	不检索
胃病吃什么药	肚子很胀，吃什么药片儿药片儿？
胃病吃什么药	不检索
控制饮食的方法。	如何控制自己少吃
辽宁省阜新市天气	阜新景点
东京奥运会	东京奥运会举办时间
吴敏霞	2021年中国队奖牌总数
吴敏霞	苏炳添东京奥运会
吴敏霞	吴敏霞金牌
喝茶的好处	喝茶的好处
喝茶的种类	茶的种类
绿茶和红茶的区别	不检索
红茶的分类	红茶分为
绿茶的好处	不检索
口红推荐	不检索
口红推荐	适合送妈妈的口红
雅诗兰黛口红	雅诗兰黛口红的质量
雅诗兰黛日常口红	雅诗兰黛日常的口红
mac口红	mac日常的口红
什么专业最有发展前景	发展好的专业
计算机专业怎么样	不检索
教师的就业前景	不检索
男女比例	男女比例好的专业
男女比例	不检索
拳击的好处	拳击课
女孩子学拳击	女生练拳击
拳击减肥	拳击减肥
减肥的方法	不检索
慢跑的好处	慢跑减肥
手机依赖	手机依赖
手机依赖	不检索
学习不专注	专注app
专注app	不检索
手机依赖	不检索
散步的好处	不检索
脖子酸	乐山天气
室内运动	室内运动推荐
做仰卧起坐的好处	运动后放松
放松和拉伸的方法	放松和拉伸的方法
放松和拉伸的方法	不检索
结婚的好处	不检索
结婚的孩子	小孩培养
陪伴小孩的方法	小孩陪伴重要性
周末陪小孩玩	父亲陪小孩的方式
儿子沟通	儿子沟通内容
毕业后从事什么工作	不检索
家政服务员	家政服务员的优点
毕业后从事什么工作	实习的好处
实习的好处	不检索
新手如何开始实习	新手如何开始实习
颈椎痛	颈椎痛
颈椎痛	缓解颈椎痛
颈椎痛	不检索
打羽毛球的好处	贵州省黔西南天气
打羽毛球的好处	不检索
手环品牌	手环品牌
苹果手环多少钱	苹果手环价格
苹果手环价格	不检索
手环品牌	不检索
卡西欧	卡西欧
教师资格考试报名	不检索
高中化学教师资格证考试	高中化学教师资格证考试
教师资格考试	教育心理学
教师资格考试	教资考试复习
高中化学教师资格证考试	不检索
教师资格考试	不检索
nba超级巨星	nba超级巨星
乔丹	nba乔丹
詹姆斯	詹姆斯
库里	詹姆斯和库里
库里三分	库里三分
吃水果的好处	不检索
橙子的好处	不检索
橙子的种类	橙子的种类
甜橙	甜橙有哪些品种？
橙子的种类	不检索
男生跳健美操	不检索
张一山健美操	张一山健美操
张一山为什么不愿回忆当年的黑历史	不检索
《摇太阳》	《摇太阳》
摇太阳歌词	不检索
手机的品牌。	手机的品牌
华为的优点	华为手机适合父母吗
华为p20pro多少钱	华为p20pro多少钱
华为p20pro拍照功能	华为p20pro像素
华为p20pro多少钱	不检索
天蝎座运势	不检索
天蝎座桃花运	不检索
和天蝎座相配的星座	和天蝎座合适的星座
妈妈的星座	不检索
巨蟹座最合适的星座	巨蟹座最合适的星座有哪些
日本奥运会羽毛球比赛	不检索
日本奥运会羽毛球燃	日本奥运会中国羽毛球比赛成绩
羽生结弦	不检索
羽毛球教练	不检索
羽毛球馆	打羽毛球的好处
出国旅行	国外疫情
国外疫情	不检索
中国最安全的省份	不检索
出国旅行注意事项	不检索
韶山美食	韶山景点
上火的原因	不检索
吃荔枝上火	吃荔枝上火
吃荔枝的危害	不检索
败火的水果	败火的水果
王老吉	不检索
西宁景点	西宁景点
西宁景点	不检索
西宁景点	不检索
西宁自然景点	西宁自然景点
敦煌	不检索
领养流浪猫	不检索
领养流浪猫需要注意什么	不检索
流浪猫可能有什么病	流浪猫可能带什么病
流浪猫可能有什么病	流浪猫领养需要注意什么
宠物医院怎么做	不检索
嫁给消防员	嫁给消防员
为什么说消防员对爱情专一	嫁给消防员
消防员管男朋友	不检索
消防员编制	消防员编制
消防员的待遇	消防员危险
消防员的职业	不检索
博士	不检索
广州高校	广州高校
广东外语外贸大学招聘	广东外语外贸大学招聘
广州的薪资	广州高校薪资
广州高校的工资水平	不检索
苹果手机	不检索
ios系统和安卓系统	ios系统和安卓系统
iphone贵	iphone贵
苹果生态	不检索
苹果系统和安卓系统区别在哪里	不检索
悬疑电影	不检索
悬疑电影	悬疑电影推荐
悬疑电影	不检索
悬疑电影	悬疑电影剧情好推荐
悬疑电影	不检索
汪苏泷的歌	汪苏泷歌曲
汪苏泷综艺	汪苏泷综艺
汪苏泷的年龄	汪苏泷
汪苏泷三大巨头	汪苏泷三大巨头
汪苏泷	汪苏泷专辑
汪苏泷	不检索
毕业季	不检索
疫情的影响	疫情下的就业困难
就业的挑战	不检索
教培倒闭	教培倒闭老师可以做什么
自媒体和互联网内容创作收入	不检索
迪丽热巴	迪丽热巴的作品
迪丽热巴	不检索
胡歌	胡歌
胡歌	不检索
仙剑奇侠传	不检索
读后感	读后感的概念
红楼梦和钢铁是怎样炼成的	红楼梦
贾宝玉	红楼梦贾宝玉
贾宝玉的女生缘	不检索
红楼梦读后感	不检索
酱牛肉	酱牛肉来源
酱牛肉的部位	酱牛肉选取部位
酱牛肉时，该如何选用调味品来突出酱香味	酱牛肉时，该如何选用调味品来突出酱香味
酱牛肉怎么做	不检索
酱牛肉怎么做	不检索
网络小说	不检索
名著的分类	不检索
名著的类型	清代的名著
网络小说	不检索
网络小说推荐	推荐的网络小说
台灯品牌	台灯品牌
台灯品牌	不检索
选台灯最重要的是什么	挑选台灯的标准
台灯的亮度标准	不检索
台灯的选择	不检索
忽视家庭的危害	忽视家庭的危害
忽视家庭的危害	如何平衡家庭和生活
如何更好的和老公孩子相处	如何加深和老公孩子的感情
沟通的重要性	和老公沟通的好处
沟通的重要性	不检索
江西省景德镇天气	江西省景德镇天气
景德镇天气	不检索
黑执事	不检索
黑执事塞巴斯蒂安的配音演员	小野大辅
风之圣痕作者	风之圣痕
圣女果的名字。	圣女果名字由来。
圣女果的名气。	不检索
圣女果的味道	不检索
圣女果和大番茄的区别	圣女果和番茄的区别。
圣女果和大番茄的区别	不检索
高考复习	不检索
甘肃省武威市的大学	广东省有哪些大学
中山大学分数线	中山大学甘肃省分数线
暨南大学	暨南大学甘肃省录取分数线
暨南大学	不检索
中国空中技巧队	不检索
单板滑雪	滑雪单板技巧
双板滑雪	双板运动技巧
滑雪摔倒后浑身酸痛	滑雪后浑身酸痛怎么办
衢州市未来一周天气	衢州市未来一周天气
衢州市未来一周天气	不检索
徐长卿中药	徐长卿中药
徐长卿作用	徐长卿作用
徐长卿外用	徐长卿外用
徐长卿外用	徐长卿外用
徐长卿牙痛	徐长卿治疗牙痛
徐长卿	不检索
摄影的好处	不检索
拍照的技巧	拍照技术
如何拍出大长腿	大长腿拍照
上面留空隙	不检索
如何拍出大长腿	不检索
打羽毛球的好处	不检索
怎么打羽毛球	不检索
羽毛球拍子	羽毛球初学
打羽毛球的技巧	羽毛球初学
打羽毛球的技巧	羽毛球初学
四大名著	四大名著
西游记	西游记经典情节
玉兔精	不检索
电视剧版的玉兔精	不检索
钢铁是怎样炼成的	不检索
推荐的口红品牌。	不检索
国产口红	国产口红
雅邦口红	不检索
雅邦口红	四五十的国产口红牌子。
vnk是一个口红牌子吗？	vnk口红。
vnk口红	不检索
锻炼的好处	锻炼对健康的好处
锻炼的好处	不检索
健康的方式	可以做什么保持健康
身体的革命本钱	不检索
养生小达人	不检索
期末考试时间	不检索
期末考试准备	怎么复习期末考试
做小抄的方法	不检索
如何缓解期末考试焦虑	怎么处理考前焦虑
如何缓解期末考试焦虑	不检索
吃冰棍的好处	酸菜白菜猪肉炖粉条
酸菜白菜猪肉炖粉条	粤菜
潮汕菜	酸梅蒸午笋鱼
酸梅蒸午笋鱼	酸梅蒸午笋鱼
客家菜	客家菜
无聊的时候干什么	天气预报
拍摄晚霞的方法	拍晚霞的方法
拍晚霞的三脚架	不检索
拍晚霞的技巧	拍晚霞的地点
附近的湖	不检索
三国演义	三国演义作者
三国演义故事	诸葛亮草船借箭
诸葛亮草船借箭	刘备故事
挥泪斩马	挥泪斩马
刘备挥泪斩马	不检索
钓鱼的好处	不检索
钓鱼水平	怎么钓鱼
手竿	不检索
大同市钓鱼	大同市钓鱼
大同市钓鱼	不检索
家里狗狗做绝育	保定宠物医院
保定宠物医院价格	宠物绝育费用
养宠物花销	不检索
狗狗绝育	宠物绝育注意事项
狗狗做绝育	不检索
中国动漫	不检索
日本动漫	不检索
罗小黑战记	罗小黑战记。
罗小黑战记	不检索
宝石之国	宝石之国动漫
游戏机的年代	不检索
玩游戏机的好处	不检索
游戏机的种类	游戏机的品牌
小霸王	小霸王可以玩的游戏
小霸王游戏	不检索
化妆品的牌子。	不检索
大宝天天见化妆品	不检索
便宜平价的彩妆	便宜平价的彩妆推荐
高光和遮瑕膏	化妆品高光
怎么画高光	不检索
买化妆品的步骤	不检索
喝奶茶的好处	不检索
喝茶的好处	喝茶好处
喝茶的好处	不检索
润喉茶	润喉茶
润喉茶药店	不检索
房地产专业学什么	如果想进房地产应该学什么专业
建筑学能做什么工作	建筑学专业能做什么工作
建筑学专业能做什么工作	不检索
房地产行业的好处	房地产行业最近景气吗
建筑学专业	不检索
电视剧开端	《开端》
《开端》的音乐	不检索
《卡农》	《卡农》的本质是循环吗？
正午阳光	《开端》正午阳光
《开端》的演员	《开端》的演员表
电视剧开端演员	不检索
柚子价格	柚子价格
红柚和白柚的区别	白柚和红柚的不同
红柚和白柚补啥	红柚微量元素
柚子的营养价值	柚子作用
柚子存放时间	柚子存放时间
柚子存放时间	不检索
哈利波特重聚节目	不检索
哈利波特电影	哈利波特电影
赫敏格兰杰	艾玛沃特森
艾玛沃特森	不检索
哈利波特电影	kindle优点
网络小说	网络小说
斗罗大陆电视剧	不检索
网络小说作家	网络小说作家
唐家三少	不检索
唐家三少	不检索
北京语言大学	北京语言大学
北京语言大学	北京语言大学的附近有什么学校
北京五道口	北京的景点
北京明天的天气	不检索
环球影城	不检索
哈利波特魔杖	哈利波特魔杖
卸妆的方法	卸妆产品
卸妆水品牌。	卸妆水推荐
卸妆水选择	挑选卸妆水的方法
卸妆水的作用	过度卸妆
卸妆水的量	不检索
穿搭	不检索
穿搭app	小红书
小红书穿搭	梨形身材穿搭
酷酷的衣服	不检索
酷酷的穿搭	不检索
玩游戏的好处	dota
英雄联盟	英雄联盟怎么样
英雄联盟	不检索
光遇	光遇
光遇	不检索
三国演义	三国演义
三顾茅庐	三顾茅庐
刘备三顾茅庐	不检索
刘备三顾茅庐	今天天气
阴转小雨	不检索
杨千嬅	不检索
杨千嬅	杨千嬅代表作
杨千嬅的歌	不检索
杨千嬅	泰勒斯威夫特代表作
泰勒斯威夫特	不检索
昆明特产	昆明特产
鲜花饼	云南鲜花饼
鲜花饼做法	不检索
被烫伤怎么办	做饭被烫伤怎么办
烫伤处理	不检索
谷爱凌	谷爱凌
谷爱凌	谷爱凌
谷爱凌模特	谷爱凌模特
谷爱凌	不检索
谷爱凌大学	谷爱凌大学
人工智能的应用	人工智能产品
智能猫砂盆	不检索
机器人公司	机器人公司国内
机器人公司	不检索
学外语的好处	公司岗位
教师资格考试	教师资格考试
当语文老师的前景	不检索
当作家的风险	网路写手收入
父母想让作家赚钱	不检索
写小说的人多了可以辞职吗	不检索
新奇宠物	新奇宠物
鸭子	当宠物的鸭子
柯尔鸭价格	不检索
柯尔鸭吃什么	不检索
柯尔鸭吃什么	不检索
蛋炒饭	炒饭用什么米
蛋炒饭	蛋炒饭配料
蛋炒饭的做法	不检索
蛋炒饭做法	隔夜米饭能放多久
蛋炒饭为什么发烧时长	不检索
好吃的零食	不检索
零食种类	零食
老干妈	老干妈
少吃辣的危害	蔬菜
西红柿的营养价值	不检索
橘子、葡萄、草莓	不检索
谈恋爱的好处	不检索
闺蜜和男朋友的恋爱	不检索
恋爱的app	恋爱社交app。
qq可以结交陌生人吗？	qqqq可以结交陌生人吗？
qq号	不检索
贾玲的综艺	不检索
贾玲参加的综艺	贾玲参加的综艺
《王牌对王牌》	《王牌对王牌》的常驻嘉宾
沈腾	不检索
沈腾和黄渤合作的电影	沈腾和和黄渤合作的电影
无印良品	无印良品都卖什么
无印良品	无印良品的无印什么意思
无印良品的logo	无印良品代理厂家
无印良品如何保证品质	不检索
无印良品的质量	不检索
宁泽涛	微博
宁泽涛退役	宁泽涛
宁泽涛退役	宁泽涛为什么退役
宁泽涛纪录片	不检索
宁泽涛	不检索
假作真时真亦假无为有处有还无	假作真时真亦假无为有处有还无
红楼梦作者	红楼梦的作者
红楼梦的作者	红楼梦的角色
林黛玉	林黛玉
红楼梦的影响	红楼梦的影响
红楼梦的内容	不检索
手账的种类	手账
手账的分类	手账怎么做
手账的分类	不检索
手账的分类	不检索
手账风格	不检索
电影手账	电影手账
冬奥	不检索
2022年冬奥会	不检索
滑雪	北京哪里有滑雪的
南山滑雪度假村	南山滑雪度假村
南山滑雪度假村	不检索
人工智能学生	不检索
华智冰	不检索
人工智能	不检索
华智冰	不检索
人工智能	不检索
研究生应该从什么时候开始找工作	研究生应该从什么时候开始找工作
研究生应该从什么时候开始找工作	不检索
当老师的好处	不检索
教师资格证考试时间	最近的教师资格证考试时间
教师资格证考试时间	不检索
元宇宙	元宇宙的定义
元宇宙	元宇宙
元宇宙	元宇宙的前景
元宇宙的应用	不检索
玩游戏的好处	不检索
基金赚钱的方法	不检索
买基金的好处	基金赚钱是什么意思
基金是怎么赚钱的	那基金是怎么赚钱的呢？
基金的风险	基金的风险是什么
买基金的风险	不检索
日照旅游	不检索
日照景点	日照旅游
傍晚去海边赶海	不检索
赶海时间	赶海时间
傍晚的天气	不检索
独生子女	独生子女
独生子女的家庭生活	不检索
生二胎的好处	生二胎
生二胎的危害	不检索
顺产和二胎有影响吗	顺产
天津武清佛罗伦萨小镇	天津佛罗伦萨小镇
武清佛罗伦萨小镇	不检索
天津武清佛罗伦萨小镇	不检索
过年买衣服	天津武清佛罗伦萨小镇
天津武清佛罗伦萨小镇	武清天气
新出的电视剧	不检索
孔雪儿	孔雪儿
孔雪儿影视作品	孔雪儿影视作品
致我们暖暖的小时光	不检索
致我们暖暖的小时光男主和女主的对手戏	不检索
高考前几天是什么时间？	中国高考
211	河南大学
河南大学	华中科技大学
985工作	不检索
高考分数	高考满分
北京旅行行李	不检索
北京景点	北京春节庙会
故宫	故宫
北京冬奥会	不检索
北京天气	北京未来7天天气预报
嘉兴市天气	不检索
嘉兴天气	不检索
摇滚	摇滚
纯音乐	纯音乐作品
《亲爱爱丽丝》现场版	最近的音乐会
考研	就业的好处
考研	不检索
英语专业可以从事哪些行业	不检索
翻译证书	大学生可以考哪些证书
英语专业考什么证书	不检索
西安疫情	不检索
西安的经济发展	西安历史
西安的美食	西安美食
西安的文化景点	西安文化景点
西安城墙	不检索
猫狗的美容	宠物美容
宠物美容价格	宠物美容价格
宠物美容内容	宠物美容内容
宠物美容内容	宠物美容内容
宠物指甲	猫狗血线
荷马史诗	荷马史诗
荷马史诗	荷马史诗
荷马史诗的作者	不检索
荷马史诗	荷马史诗
史诗的含义	史诗
《舞蹈风暴》	《舞蹈风暴》
《舞蹈风暴》李响	怎么学会古典舞
李响跳的古典舞	李响跳舞
《舞蹈风暴》的初衷	《舞蹈风暴》的初衷
《舞蹈风暴》的质量	对于《舞蹈风暴》的评价
学舞蹈的基础	初学舞蹈注意什么
补水喷雾推荐	好用的补水喷雾牌子
雅漾的补水喷雾的价格。	雅漾的补水套装价格
平价的补水喷雾。	平价的补水化妆品品牌
雅漾的补水喷雾价格。	不检索
仙桃市天气	不检索
模拟城市：我是市长。	模拟城市：我是市长
模拟城市：我是市长游戏技巧	模拟城市：我是市长
模拟城市：我是市长	模拟城市：我是市长
模拟城市：我是市长活动	模拟城市：我是市长活动
模拟城市：我是市长	不检索
天涯四美	天涯四美
钟汉良李小冉民国剧	钟汉良李小冉民国剧
钟汉良李小冉来了说我爱你	不检索
谢大脚	于月仙
于月仙	不检索
将进酒李白	将进酒李白
将进酒歌曲	将进酒歌曲
凤凰传奇	不检索
凤凰传奇男女主唱	凤凰传奇的男女主唱的名字
凤凰传奇男女主唱	不检索
吉林省白城市天气	吉林省白城市天气
吉林省白城市天气	如何保暖
白城天气	吉林白城地理位置
吉林白城公园	不检索
向海百鸟园	不检索
炸鸡	不检索
炸鸡口味	不检索
吃炸鸡腻	吃炸鸡腻怎么办
柠檬水	柠檬水的做法
喝柠檬水的好处	喝柠檬水的好处
doyoulikefishinge	不检索
捕鱼的渔具	不检索
河流挖沙	农村河流挖沙
挖沙的好处	不检索
浣溪沙	不检索
烘干机洗衣机	烘干机洗衣机
宜昌市美食	湖北省宜昌市美食
宜昌市美食	不检索
宜昌市天气	这个杀手不太冷静
宜昌市天气	不检索
宜昌市电影院	宜昌市电影院
宜昌步行街	不检索
广西高考报考学校	不检索
高考600分	不检索
北京的大学	600分可以上的北京的大学。
人民大学	人民大学的广西录取分数线。
人民大学	不检索
小米8se手机	小米8se手机
小米8se	不检索
小米8se内存	小米12
苹果的旗舰机	苹果13价格
小米旗舰机价格	小米旗舰机价格
雷军	雷军
星座	不检索
巨蟹座性格	巨蟹座性格
巨蟹座性格	不检索
星座可信吗	星座天文学
星座的天文学知识	不检索
三国演义	三国演义
三国演义的真实故事	三国演义是真实的故事吗
诸葛亮真的存在吗	诸葛亮真实存在吗
诸葛亮出师表	不检索
出师表	不检索
记忆力强的人	真的有人过目不忘吗
王子文新剧	王子文新剧
第二次也很美	不检索
王子文	第二次也很美
张鲁一和于明加	不检索
《第二次也很美》的评价	不检索
周末的娱乐	不检索
淮南市天气	钓鱼要准备的东西
如何钓鱼	钓鱼的步骤
钓鱼的书籍	不检索
淮南市钓鱼地点	安徽淮南可以钓鱼的地方
牡丹	牡丹成活率
牡丹的好处	牡丹中国
牡丹的种类	牡丹种类
淘宝牡丹	淘宝牡丹苗
月季和牡丹一样吗	月季和牡丹的区别
月季的品种	不检索
失眠的危害	失眠问题
为什么现在失眠的人越来愈多	为什么现在失眠的人变多了
治疗失眠的方法	治疗失眠的方法
治疗失眠的方法	不检索
治疗失眠的药	不检索
星座可信吗	不检索
星座的原理	星座的原理
星座的起源	不检索
星座	不检索
天蝎座性格特点	天蝎座的性格特点
普通话	普通话
方言和普通话的区别	方言和普通话
郑州方言	郑州方言
郑州方言	不检索
郑州方言	不检索
苹果手机	不检索
性价比高的手机	性价比高的手机
拍照录视频的软件	小米note像素
性价比高的手机	性价比高的手机
小米note性价比高的手机	不检索
诗歌朗诵的好处	不检索
诗歌朗诵的方法	诗歌朗诵的方法
诗歌朗诵的方法	不检索
诗歌朗诵的感觉	不检索
诗歌朗诵的方法	不检索
跳绳减肥吗？	跳绳能减肥吗？
跳绳要跳好多下	跳绳要跳多少下才能减肥？
跳绳30分钟	不检索
跳绳能跳多少下？	不检索
跳绳的好处	不检索
网易软件公司	网易公司部门
网易公司部门	网易公司部门
网易公司工资	网易公司工资
网易公司工资	网易公司部门
面试经验技巧	面试经验技巧
网易公司面试技巧	不检索
国风舞蹈	不检索
国风舞蹈	不检索
国风舞蹈	国风舞蹈
国风舞蹈	不检索
古典舞学习	如何跳古典舞
初学古典舞的方法	不检索
贺岁档电视剧	贺岁档电影
新喜剧之王	新喜剧之王
新喜剧之王	周星驰
新喜剧之王吴孟达	新喜剧之王
新喜剧之王	不检索
基金的投资方法	不检索
基金的类型	基金的类型
基金经理	基金经理
新手如何选择基金	不检索
新手如何选择基金	不检索
银行卡	不检索
交通银行r2	理财产品中低风险r2
安增益31天	安增益31天
安增益31天抢不到额度	不检索
安增益31天抢不到额度	不检索
夏天的景点	夏天推荐旅游景点
夏天去草原热吗	夏天去内蒙古草原热不热
夏天去内蒙古草原	夏天去草原注意什么
去内蒙古草原游玩	夏天内蒙古草原上美食
内蒙古草原景点	夏天蒙古草原好玩项目
中国的诗歌	中国古诗
唐诗	什么是唐诗
唐诗的影响	什么是唐诗
唐朝诗人	唐朝诗人
李白	李白
吃零食的危害	零食种类
新口味的零食	不检索
乐事薯片	不检索
上好佳咸蛋黄口味薯片	上好佳
上好佳虾条	不检索
咸蛋黄口味薯片	不检索
酷酷的衣服	不检索
穿搭风格	酷风格
酷的风格	原宿风
原宿风博主	不检索
内卷风格	寂风
好吃的零食	不检索
三只松鼠甜品小零食	三只松鼠甜品零食
便宜的零食	便宜甜味零食
辽宁省葫芦岛市天气	不检索
黑芝麻饼	不检索
春节去哪里旅游	不检索
带爸爸妈妈旅行	带爸爸妈妈旅行注意
旅游景点	不检索
游轮旅行	游轮旅行
游轮旅行花销	游轮旅游价格
眼睛有血丝	眼睛有血丝
结膜炎	结膜炎原因
风大的原因	不检索
结膜炎需要打疫苗吗	结膜炎治疗方法
结膜炎治疗	不检索
冬天吃的水果	冬天吃的水果
草莓和樱桃	草莓推荐
冬天吃草莓的好处	车厘子
车厘子的营养价值	车厘子价格
吃车厘子的好处	不检索
网购水果	不检索
公务员考试	河源和平公务员报考
河源公务员考试报名人数	公务员面试技巧
公务员面试准备	不检索
河源公务员招考岗位	河源公务员招考岗位
选调生的优势	选调生优势
名著推荐	名著推荐
外国名著	外国名著推荐
外国神话	外国神话
诺亚方舟	诺亚方舟
圣经	圣经
推荐的音乐	不检索
英文歌曲	不检索
酷玩乐队	酷玩乐队
yellow	郑钧流星
郑钧的歌	不检索
郑钧的歌	不检索
车厘子	车厘子好处
车厘子贵吗	车厘子便宜的购买
水果	不检索
水果沙拉	水果沙拉做法
水果沙拉	水果沙拉类型
平家物语	平家物语
平家物语	不检索
最近很火的动漫	日本动漫有哪些
龙珠	不检索
寒假时间	不检索
房地产行业景气吗	不检索
北上广的房价	北上广的房价
深圳房价	深圳房价怎么样？
深圳二手房	深圳买二手房划算吗？
深圳房价	不检索
耳鸣原因	什么导致耳鸣
耳鸣原因	不检索
新冠疫苗	疫苗会导致耳鸣吗
最近耳鸣的原因	不检索
中成药能缓解耳鸣吗	什么药能缓解耳鸣
克拉玛依天气	不检索
完美世界	完美世界
石昊	不检索
辰东还有其他作品吗	辰东还有其他作品吗
辰东的新作品	辰东的新作品
跳舞的好处	不检索
拉丁学习	拉丁分类
拉丁考级	拉丁舞金星好考吗
金星学多久了？	不检索
金星老师	不检索
漳州堵车	不检索
漳州交通	漳州地铁
漳州地铁	漳州地铁
厦门地铁6号线运营时间	厦门地铁6号线运营时间
厦门地铁6号线	不检索
设计衣服的灵感	不检索
当服装设计师难吗	当服装设计师难吗
学习服装设计的学校	学习服装设计的学校
云南省的服装设计学院	不检索
学习服装设计的方法	不检索
龚俊的古装戏	龚俊作品
龚俊	不检索
迪丽热巴	迪丽热巴作品
张予曦	不检索
张予曦《夜色暗涌时》	张予曦作品
学中医的好处	不检索
现代人为什么越来越重视中医	不检索
中医养生	中医养生的体系
中医比西医更重视人的整体	不检索
现代人的职业病	不检索
菠萝蜜	菠萝蜜价格
菠萝蜜买	不检索
菠萝蜜的营养价值	菠萝蜜快递
菠萝蜜的营养价值	菠萝蜜一天能吃几个
菠萝蜜和菠萝有什么关系	菠萝蜜名字的由来
菠萝蜜为什么叫菠萝	不检索
咒术回战	不检索
咒术回战	不检索
咒术回战五篇	不检索
虎杖悠仁	虎杖悠仁
咒术回战	不检索
甄嬛传	甄嬛传孙俪
甄嬛传十七爷	甄嬛传十七爷
赵氏孤儿	赵氏孤儿电影
赵氏孤儿李东学	赵氏孤儿电影
赵氏孤儿导演	赵氏孤儿导演
大明宫词	不检索
疫情	不检索
降低生活成本的方法	不检索
拼多多假货	拼多多假货多吗
拼多多的电子产品能在拼多多买吗	拼多多苹果店
拼多多的app	不检索
岳阳市历史悠久	岳阳市的历史
岳阳市景点	不检索
学历史的方法	学历史的方法
学历史的方法	高分历史书籍
读历史的方法	不检索
手游	不检索
消消乐	热门手游
和平精英	不检索
和平精英段位	和平精英段位
和平精英段位	不检索
理财的好处	理财
基金	怎么炒基金
为什么关注超跌的基金	怎么炒基金
学习基金的方法	不检索
买基金的注意事项	不检索
买基金的注意事项	不检索
秦皇岛景点	秦皇岛旅游
秦皇岛景点	北京秦皇岛
秦皇岛高铁	山海关
秦皇岛天气	不检索
山海关清明假期	不检索
小孩玩手机的危害	不检索
玩手机的害处	玩手机的害处
玩手机的危害	玩手机会变丑
玩手机的危害	不检索
玩手机的危害	不检索
零食	不检索
好吃的零食	零食分类
好吃的零食	不检索
辣条	辣条
辣条	不检索
吃辣条的好处	不检索
杜甫	杜甫
杜甫是什么	不检索
杜甫的风格	杜甫的风格
杜甫的风格	杜甫的风格
杜甫的诗	杜甫的诗
养宠物的好处	不检索
养宠物的好处	不检索
小狗狗	不检索
小型犬	小型犬有哪些
博美好养吗	博美好养吗
网易云音乐	音乐软件
网易云为什么这么差	不检索
纯音乐	不检索
白噪音	白噪音
asmr	asmr
元宇宙火	元宇宙火
头号玩家	元宇宙头号玩家
元宇宙	不检索
元宇宙应用	元宇宙生活
元宇宙的概念	不检索
冬天户外运动	冬天户外运动
室外冰场	室外冰场
冰车	不检索
冬奥会	冬奥会时间
北京冬奥会导演	北京冬奥会开幕式导演
春晚的舞蹈	《只见青绿》
青绿腰	抖音
春晚的舞蹈	《朱》
《这就是街舞》	《这就是街舞》朱洁净
《暮光之城》	不检索
谷爱凌u型道	不检索
谷爱凌断层第一	不检索
u型场地的比赛规则	滑雪u型池场地规则
u型滑板和双板大跳台的板一样么？	u型池场地滑板
滑雪滑板	不检索
过年的习俗	大年三十
兔年的运势	兔年的性格
兔年的特点	不检索
过年的气氛	过年大家做什么
贴春联的意义	贴春联
春晚的节目	不检索
嘉兴市景点	嘉兴天气
嘉兴景点	嘉兴景点
乌镇戏剧艺术节	乌镇戏剧艺术节
乌镇戏剧艺术节	不检索
乌镇的景点	不检索
退休生活	不检索
生活质量下降	不检索
养老院的待遇	养老院照护内容
养老院的娱乐项目	不检索
养老院的轰趴馆	不检索
庆余年	庆余年的演员有哪些
陈道明	陈道明的戏
陈道明的演技	陈道明的演技怎么样
陈道明的戏路	陈道明对待戏是怎么样的？
陈道明	不检索
陈道明	对待陈道明的评价
针灸的好处	针灸疼不疼
容嬷嬷	容嬷嬷扎针
针灸的作用	针灸的作用
针灸穴位	不检索
针灸穴位	不检索
富士滤镜	富士滤镜
富士滤镜	富士滤镜
富士相机滤镜	不检索
富士单反	不检索
索尼相机	不检索
喝排骨汤的好处	不检索
炖汤的好处	不检索
炖汤的注意事项	炖汤步骤
炖肉的汤	蔬菜汤
蔬菜汤	不检索
作家	不检索
东野圭吾	东野圭吾
解忧杂货店	解忧杂货店
解忧杂货店	不检索
王小波	不检索
中国历史上的皇帝	贞观之治
唐代美食	唐代美食
唐朝冷面	槐叶冷淘
槐叶冷淘	四川冷面
鸡丝凉面	不检索
武汉景点	武汉景点
黄鹤楼	黄鹤楼
黄鹤楼诗	黄鹤楼唐诗
黄鹤楼票价	黄鹤楼门票多少？
黄鹤楼门票	不检索
自然堂的化妆品怎么样？	自然堂怎么样？
资生堂	资生堂
自然堂的化妆品	不检索
自然堂的化妆品价格	不检索
强烈建议不要买太贵的化妆品	不检索
李荣浩。	不检索
张靓颖	张靓颖
张靓颖画心	张靓颖画心
唱歌的好处	不检索
朋友少的原因	唱歌软件
电视剧今生有你	电视剧今生有你
李小冉	李小冉
钟汉良	钟汉良
电视剧《天涯明月刀》	电视剧《天涯明月刀》
钟汉良	钟汉良
张爱玲电影	《第一炉香》
《第一炉香》	《第一炉香》小说
《第一炉香》的作者葛薇龙。	倾城之恋
张爱玲的作品	不检索
倾城之恋	不检索
倾城之恋电影	不检索
佛手柑	佛手柑
佛手柑怎么吃	佛手柑怎么吃
佛手柑	佛手柑的好处
佛手柑的好处	不检索
佛手柑	不检索
互联网猝死	不检索
打羽毛球的好处	打羽毛球好处
羽毛球的好处	羽毛球如何练习
林丹	林丹羽毛球
林丹	不检索
经典名著	外国名著
三国演义的内容	三国演义的内容
三国演义的内容	三国演义的内容
三国演义的内容	三国演义的内容
罗贯中	罗贯中
日本动漫	2021年新番
beastars	不检索
国王排名	国王排名
波吉王子	不检索
jojo	不检索
吃零食的危害	不检索
减脂零食	不检索
健康的零食	不检索
麻辣香锅	鸡胸肉
低卡零食	代糖
穿什么衣服最合适	不检索
舒服的衣服	衣服品牌
女生穿什么衣服比较舒服	比较舒服的女性服装品牌
服装设计师的书	服装设计的书
服装设计的书	不检索
《新婚公寓》	《新婚公寓》
《新婚公寓》男女主	不检索
李晟	李晟的作品
失宠王妃之结缘	不检索
失宠王妃之结缘	不检索
李荣浩的歌	阿刁
阿刁歌手	不检索
张韶涵	你喜欢的歌手是张韶涵吗？
张韶涵的歌	不检索
张韶涵	不检索
深信服公司	深信服
深信服软件公司	不检索
华为公司	华为公司
华为公司	不检索
华为的实力	不检索
怎么养老	如何养老
养老院	养老院费用
半自理护理	不检索
养老院的费用	不检索
养老院的好处	不检索
加湿器推荐	干燥加湿器
加湿器牌子	加湿器牌子
小熊电器	不检索
小熊电器	北京马连洼商场
北京哪里可以买到加湿器	不检索
美白效果好的化妆品	美白效果好的化妆品
olay精华露多少钱？	olay精华霜的价格
olay精华霜哪里买	不检索
微商	不检索
微信公众号	不检索
英语考试	英语考试方法
英语学习方法	英语的学习方法
英语过段时间能不能进步	不检索
文科和理科的区别	文科理科
文科和理科的区别	不检索
最近的电视剧	不检索
开端电视剧	开端电视剧
赵今麦	赵今麦
《流浪地球》	流浪地球
流浪地球	不检索
钓鱼的好处	不检索
第一次钓鱼	不检索
晒伤的渔具	晒伤了怎么办
治晒伤的膏药	晒伤的膏药
晒伤的膏药	不检索
网球运动员	不检索
费德勒	费德勒
除了费德勒你还有哪些喜欢的网球运动员	著名男子网球运动员
德约	不检索
费德勒	不检索
马龙乒乓球比赛	不检索
马龙和许昕的比赛	不检索
马龙弱点	不检索
马龙	马龙冠军
马龙	不检索
克孜勒苏柯尔克孜自治州	不检索
附近的餐馆	不检索
宿舍烧饭	不检索
宿舍吹风机	不检索
小功率小锅	不检索
厨房菜	不检索
梧州景点	梧州天气
梧州天气	人物摄影技巧
梧州天气	梧州的公园
梁羽生公园	不检索
梧州景点	不检索
新疆维吾尔自治区克孜勒苏柯尔克孜自治州	不检索
克孜勒苏柯尔克孜自治州	不检索
克孜勒苏柯尔克孜自治州	不检索
克孜勒苏柯尔克孜自治州	不检索
3月21日，新疆维吾尔自治区克孜勒苏柯尔克孜自	不检索
桑巴跳	不检索
桑巴跳	桑巴
桑巴节奏	b站
跳桑巴的博主	不检索
博主	不检索
雅思考试	雅思
雅思报名费	雅思报名费
雅思报名费	雅思考试内容
雅思口语表达能力	如何提高雅思口语
雅思考试内容	不检索
昌都美食	昌都
三江流域	三江流域
昌都的地理位置	昌都
昌都美食	昌都美食
昌都美食	昌都美食
香奈儿	香奈儿的品牌历史
可可香奈儿	可可香奈儿如何创立香奈儿
香奈儿的品牌形象	香奈儿的品牌形象
香奈儿最经典的包包	香奈儿的经典包包
淘宝上的香奈儿包包价格	不检索
跳舞减肥	不检索
跳舞减肥的舞蹈	跳舞减肥的舞蹈种类
爵士舞	爵士舞风格
爵士舞的特点	不检索
爵士舞学习	不检索
春天里的天气	今天天气
小香风	小香风
小香风流行的原因	小香风流行时间
小香风流行的原因	不检索
喇叭裤腿型	不检索
小说	不检索
谋杀记忆	谋杀记忆
高铭	不检索
天才在左疯子在右	天才在左疯子在右创作背景
天才在左疯子在右	不检索
锅巴	无名小卒锅巴
好吃的锅巴	不检索
好吃的零食	咸蛋黄口味零食
咸蛋黄口味的零食	不检索
咸蛋黄口味的零食	不检索
鱼片鱿鱼丝	好吃的鱿鱼丝零食
三只松鼠零食	不检索
互联网公司待遇	互联网公司待遇
互联网公司待遇	互联网热门游戏
上网速度慢的原因	不检索
网易公司	不检索
装系统都不会的女生	不检索
工作压力大	工作压力大如何缓解
王菲的歌	王菲的歌
王菲的歌	戴耳机听歌的危害
推荐的音响	品质高的音响
西宁商场	西宁天气
作家	不检索
江南	不检索
江南	不检索
东野圭吾	不检索
《此间的少年》	不检索
《此间的少年》	不检索
名侦探柯南情人节杀人事件	不检索
名侦探柯南情人节杀人事件	不检索
名侦探柯南更到多少集了？	名侦探柯南现在更到多少集了？
名侦探柯南	不检索
名侦探柯南变回新一了吗？	柯南变回新一了吗？
唐山人生地不熟	不检索
唐山地铁	唐山有地铁吗
唐山到北京的距离	唐山市区面积
唐山中心两区	唐山发展主要在路南区吗
唐山未来发展	不检索
背单词的方法	四级考试的词汇量要求是
四级英语考试词汇量要求	大学英语四级多少分及格
四级考了多少分？	不检索
百词斩	百词斩是什么
百词斩	不检索
秃头的原因	秃头的原因
秃头原因	如何缓解大量脱发
吃水果的好处	不检索
梧州天气	不检索
梧州天气	不检索
粉底液卡粉起皮	不检索
粉底液推荐	粉底液推荐
遮瑕膏推荐	遮瑕膏推荐
dior口红	dior口红色号
dior999口红色号	不检索
找对象的注意事项	不检索
谈恋爱的经验	不检索
和女生交流就浑身不自在	和女生交流就浑身不自在
女生喜欢的话题	女生喜欢交流话题
影视行业	不检索
杨幂的长相	杨幂的剧
《三生三世十里桃花》	《三生三世十里桃花》
杨幂的长相	不检索
杨幂古装	不检索
杨幂演过什么现代剧	不检索
苏州留园	苏州留园
苏州天气	苏州明日天气
苏州明日天气	不检索
在家做什么	在家有趣的活动
在家带孩子	不检索
乒乓球	不检索
马龙	马龙
马龙全满贯	马龙
体育赛事	体育赛事软件
马龙	不检索
樊振东	不检索
研究生毕业的就业方向	不检索
动植物检疫专业	动植物检疫专业
电气工程专业就业	国家电网待遇好
华为的待遇	电气工程专业课程
电气工程博士	电气工程博士
纳达尔	纳达尔
纳达尔	不检索
纳达尔	不检索
费德勒	费德勒
费德勒	不检索
女团舞	女团舞
跳hiphop的好处	不检索
twice	twice代表作
女团舞的学习方法	跳女团舞的注意事项
跳舞受伤	跳舞受伤怎么办
星座的由来	星座是怎么来的
古巴比伦	古巴比伦
古巴比伦	不检索
星座的由来	星座是什么
星座的起源	不检索
星座的含义	不检索
深圳天气	深圳天气
深圳天气	深圳的气候
深圳天气	雨天要注意什么
下雨天注意事项	打雷要注意
下雨天会不会很冷	天气
长津湖电影	长津湖电影简介
长津湖演员	长津湖电影演员
易烊千玺	不检索
易烊千玺	不检索
长津湖第三部	长津湖之水门桥电影
长津湖电影	不检索
什么水果最贵	什么水果最贵
最便宜的水果	最便宜的水果是什么
圣女果	圣女果的营养价值
圣女果	不检索
榴莲的营养价值	不检索
年下男	年下男
我叫金三顺	我叫金三顺
交友app	陌陌安全吗
杀猪盘	杀猪盘是什么
陌陌	不检索
新疆塔城天气	新疆塔城天气
新疆美食	八角梨
八角梨	新疆美食
羊肉串	不检索
新疆的羊肉串	新疆羊肉串
羊肉串配什么酒	不检索
日本历史	日本历史如何了解
日本历史	了解历史的益处
朋友的影响	朋友的正影响
和性格开朗的人交朋友	不检索
男女比例	不检索
厦门景点	厦门
厦门景点	厦门
厦门景点	厦门景点
厦门大学	厦门景点
厦门景点	厦门景点
就业前景好的专业	就业前景好的专业
适合女生的专业	适合女生学的专业
当老师的好处	不检索
当老师的好处	不检索
学医的好处	不检索
北京疫情	北京1月21日新增确诊有多少
北京疫情	不检索
北京海鲜市场疫情	北京京深海鲜市场疫情
京深海鲜市场问题	不检索
北京疫情	不检索
寒假	不检索
最近上映的电影	最新电影
看动漫的好处	最新动漫
灌篮高手	灌篮高手
流川枫	流川枫
中国历史的介绍	不检索
唐朝第一个皇帝	唐朝第一个皇帝
李渊是好皇帝吗	李渊是好皇帝吗
李渊的子孙	唐朝的第二个皇帝
武则天怎么成为的皇帝	武则天怎么成为的皇帝
武则天	武则天怎么样
旅行的好处	3月适合去哪里旅行
大理景点	大理哪里适合
大理的自然景点	大理的自然景观
关于洱海的诗句	关于洱海的诗句
大理景点	不检索
动漫的快乐源泉	不检索
蜡笔小新	蜡笔小新
蜡笔小新	不检索
柯南	名侦探柯南一共有几部
柯南一共19部	不检索
最近的基金是什么时候火的	基金
证券投资基金	证券投资基金
余额宝	不检索
基金的风险	不检索
微信的app	不检索
理财小能手	不检索
刘震云	刘震云
刘震云	不检索
一日三秋	一日三秋
一日三秋	不检索
《手机》	不检索
灰指甲	不检索
脚指甲变厚变黄	脚指甲变厚变黄
灰指甲检查	不检索
路边的修脚店灰指甲	路边的修脚店灰指甲
脚气	不检索
灰指甲挂号	灰指甲医院挂号挂什么科
单身的好处	如何拥有恋爱
恋爱的方法	恋爱小技巧
好的恋爱关系	不检索
恋爱的好处	不检索
如何脱单	不检索
香蕉的好处	香蕉
香蕉的营养价值	香蕉的营养
香蕉的好处	食用香蕉的种类
小米蕉	小米蕉
香蕉为什么是黄色的	香蕉为什么是黄色的
吃香蕉的好处	不检索
香港假期	不检索
北京胡同	不检索
南锣鼓巷	南锣鼓巷
南锣鼓巷	不检索
北京特色纪录片	不检索
荆门景点	荆门景点
荆门景点	荆门景点
钟祥莫愁湖	钟祥莫愁湖
王莽洞	王莽洞景点
钟乳石	不检索
减脂的零食	不检索
减肥的方法	减肥方式
吃零食的危害	减脂零食
低卡零食	低卡零食
低卡零食	不检索
辣椒酱的种类	不检索
辣椒酱的种类	小米椒
小米椒	不检索
辣椒酱原料	辣椒酱原料
辣椒酱里可以放什么水果	辣椒酱原料
养宠物的好处	养宠物
仓鼠	养仓鼠
养仓鼠的器具	养仓鼠
养仓鼠的好处	养仓鼠
养仓鼠的生活习性	养仓鼠
专业的重要性	不检索
转专业的专业	冶金专业
冶金专业转专业	感到迷茫怎么办
辅导员的作用	不检索
找辅导员的方法	不检索
什么年龄谈恋爱的最佳时期	什么年龄谈恋爱的最佳时期
什么年龄谈恋爱最佳时期	不检索
工作两年后谈恋爱	怎样平衡家庭和工作的关系
什么年龄是谈恋爱的最佳时期	不检索
什么年龄是谈恋爱的最佳时期	不检索
养生的好处	养生的好处
养生的好处	不检索
养生图案	不检索
枸杞的好处	枸杞的好处
枸杞可以保护眼睛吗	不检索
光遇游戏	光遇游戏公司
光遇游戏	不检索
光遇怎么进到隐藏图	不检索
光遇游戏	光遇乐器
光遇乐器	光遇乐器
大城市房价	上海房价
二线房价	二线房价
二线房价	不检索
二线房价	不检索
广州的城中村	不检索
肯德基可乐鸡翅	肯德基可乐鸡翅
可乐鸡翅包饭	可乐鸡翅包饭
可乐鸡翅包饭	美食可乐鸡翅
早茶鸡翅	广东早茶鸡翅
早茶鸡翅	可乐鸡翅味道
可乐鸡翅	不检索
lv奢侈品为什么贵	lv奢侈品那么贵
lv在中国什么卖的最火啊	lv在中国什么卖的最火啊
lv怎么买到正品	不检索
lv在中国什么卖的最火。	不检索
lv为什么贵	不检索
英雄联盟	不检索
德玛西亚之力盖伦	金克丝
《双城之战》的女主角	英雄联盟双城之战
edg战队	不检索
edg的meiko	英雄联盟edg的队员介绍meiko
转校生	不检索
转校生netflix	转校生netflix泰国
转校生娜诺	转校生娜诺
转校生仇恨未放下	不检索
转校生	不检索
穷游	没有钱怎么旅行
穷游	怎么穷游
旅游景点	饮食方面怎么穷游
交通	交通可以怎么省钱
青年旅社	青年旅社
穷游	穷游的坏影响
长痘痘的原因	长痘的原因
吃油腻的食物	长痘的原因
熬夜的危害	长痘的原因
长痘的原因	不检索
熬夜的危害	不检索
为什么不想生孩子	现在人不生孩子的原因
为什么女性不想生孩子	不检索
生孩子对女性身体的伤害	生孩子对女性身体的伤害
为什么不生孩子	不检索
丁克家庭	不检索
草莓的季节	草莓的季节
冬天的草莓是怎么种出来的	冬天草莓如何种植
草莓蛋糕	不检索
草莓蛋糕做法	草莓蛋糕的做法
草莓蛋糕做法	不检索
中医怎么样	不检索
中医的优点	不检索
中医的优点	不检索
学医的好处	不检索
中医的工资	不检索
河北邯郸大学	不检索
北京211学校	北京市的211学校
高考注意事项	北京外国语大学
北京外国语大学	不检索
北外学姐	不检索
周杰伦	中国流行歌手top3
周杰伦稻香	周杰伦稻香歌词
需要人陪	需要人陪歌手
周杰伦拍电影	周杰伦拍电影导演
《不能说的秘密》	不检索
美食博主	美食博主
学做饭的方法	学做饭
学做饭的手	学做饭
学做饭的方法	不检索
速食	速食好吃
拼多多绿色卫衣	不检索
绿色卫衣的优点	不检索
绿色卫衣的优点	不检索
绿色卫衣搭什么裤子能显瘦？	绿色卫衣搭什么裤子显瘦？
绿色卫衣搭什么裙子好看	绿色卫衣，搭什么裙子好看？
宝鸡景点	宝鸡旅游景点
宝鸡景点	不检索
太白山	太白山
太白山	不检索
宝鸡天气	大唐秦王陵
房地产公司倒闭	不检索
北京房价	北京房价
北京房价	北京房价
北京朝阳区房价	北京朝阳区房价
北京朝阳房价	不检索
内江景点	四川内江景点
内江景点	不检索
内江景点	内江东兴区山
内江明天天气	内江明天天气
内江景点	不检索
内江长坝山	不检索
电子手环的牌子。	国产智能手环的牌子。
小米手环怎么样？	小米手环
小米手环能打电话吗？	不检索
小米手环的价格。	小米手环6多少钱？
小米手环的价格。	不检索
手痛	不检索
手痛的原因	不检索
玩游戏的危害	不检索
腱鞘炎	腱鞘炎
鼠标手	鼠标手
鼠标手	不检索
冬奥会	北京冬奥会
武大靖	冬奥会的项目
武大靖	武大靖
平昌冬奥会短道速滑比赛	平昌武大靖
武大靖	武大靖是如何努力的
武大靖	不检索
福建龙岩天气	不检索
福建龙岩景点	福建龙岩旅游点
摄影设备	摄影设备
怎么拍出好看的照片	不检索
学习摄影的方法	不检索
四川美院	四川美院
进川美的经验	不检索
四川美院高中毕业	不检索
艺术生	高考艺术生
高考分特长班	不检索
原画师	不检索
原画师的薪资	原画师收入
原画师学历要求	原画师招聘学历要求
厦门原画培训机构	厦门原画培训机构
厦门原画培训	k大网课
原画师培训	不检索
红楼梦	不检索
红楼梦电视剧	不检索
红楼梦前八十回	不检索
林黛玉	林黛玉
林黛玉结局	林黛玉结局
中医的好处	不检索
中医的好处	胃口不好喝中药管事吗
吃中药的好处	中医按摩
中医的好处	不检索
中医的学习教程	中医是科学的吗
中医的副作用	中药有副作用吗
南非旅游套装	南非观光旅游套装
南非夏天的景点	南非夏天的景点
南非夏天的景点	不检索
南非7月份的天气	南非7月份的天气
南非的龙虾餐	不检索
冬奥会	不检索
中国现在几枚金牌	不检索
奥运金牌	不检索
日本花样滑冰名将	羽生结弦
羽生结弦	不检索
西游记	《西游记》电视剧版
86版西游记人物	不检索
孙悟空扮演者六小龄童	不检索
红楼梦	林黛玉和贾宝玉
红楼梦	不检索
网络小说	不检索
村上春树的小说	村上春树的作品
《挪威的森林》	博尔赫斯
看不懂的书怎么办	不检索
看书的好处	不检索
陪伴老人	陪伴老人
康熙王朝	康熙王朝主题曲
康熙王朝主题曲	不检索
向天再借五百年	向天再借五百年
向天再借五百年	韩磊歌手
年花	春节年花
水仙花叶子黄	水仙叶子黄
水仙花放在暖气片附近	蝴蝶兰春节
押花	押花怎么做
送老师的花	老师花
山茶花	不检索
洛阳的景点	不检索
洛阳历史底蕴	洛阳的历史底蕴
龙门石窟	龙门石窟
洛阳美食	洛阳的美食有哪些
洛阳美食	不检索
家里养宠物	不检索
养金鱼需要准备什么	养金鱼准备
金鱼的种类	金鱼的种类
养金鱼的注意事项	养金鱼的注意事项
养金鱼的注意事项	不检索
参观金鱼	不检索
泰国电影	泰国的电影
《初恋这件小事》	《初恋这件小事》
《初恋这件小事》	不检索
《天才枪手》	《天才枪手》
《天才枪手》	《天才枪手》
《天才枪手》	不检索
玩游戏的好处	不检索
玩游戏的好处	不检索
英雄联盟公司	腾讯《英雄联盟》
英雄联盟	不检索
梦幻西游	《梦幻西游》
《梦幻西游》	不检索
开端电视剧	不检索
《开端》	《开端》
无限流电视剧	不检索
电视剧开端	无限流
《土拨鼠之日》	不检索
无限流剧情	不检索
千与千寻	千与千寻
宫崎骏的寓意	幽灵公主
幽灵公主的音乐	宫崎骏久石让
久石让	听音乐的好处
工作压力大	工作压力大如何缓解
熬夜的危害	几点算熬夜
武则天是中国第一个女皇吗？	武则天是中国第一个女皇吗？
武则天怎么成为的女皇帝	武则天怎么成为的女皇帝
武则天的贡献	武则天的贡献
武则天时期的百姓生活	武则天时期的百姓生活
唐朝的繁华	唐朝很繁华吗
关于唐朝历史的纪录片或者电影推荐	关于唐朝历史的纪录片或者电影推荐
跑步的好处	跑步的好处
跑步的好处	不检索
跑步的好处	不检索
操场跑步	不检索
跑步听歌	跑步适合听的歌
朴树	不检索
一个人在家做什么	不检索
鱼香肉丝	鱼香肉丝怎么做
鱼香肉丝	不检索
鱼香肉丝的做法	不检索
糖醋里脊	糖醋里脊
糖醋里脊	不检索
东莞天气	不检索
东莞天气	东莞雨季
东莞天气	不检索
东莞冬天天气	东莞冬天温度
东莞天气	不检索
东莞天气	不检索
日本的景点	不检索
日本的温度	日本是什么气候特征
温带性海洋性季风气候	温带性海洋性季风气候
日本经常下雪吗	日本经常下雪吗
日本的景点	日本的景点
富士山	富士山是活火山吗
经常化妆的危害	不检索
皮肤好的化妆品	怎么保养皮肤
额头长痘	额头长痘
额头长痘	不检索
什么口红可以不用	不检索
电视剧	不检索
电视剧	盗墓笔记电视剧
李易峰	不检索
李易峰	电影频道
寒假上映的电影	不检索
电视剧	日剧有哪些
为了n犯罪剧	为了n
为了n的剧情	日本犯罪剧
在无爱之森呐喊	不检索
日本犯罪电影	不检索
培养孩子的方法	培养孩子
两岁的孩子	两岁的孩子
两岁的孩子为什么总喜欢哭	两岁的孩子
两岁的孩子能说话吗	不检索
语言习得关键期	语言习得关键期
教孩子外语的方法	不检索
考编有必要报班吗	考编要不要报班
体制内的好处	体制内的好处
考编的好处	不检索
考编年龄限制	考编年龄限制
考编年龄限制	不检索
射手座出生时间	射手座
射手座的性格	射手座的性格
射手座最近的运势	射手座的近期运势
射手座最适合和哪个星座成为朋友	不检索
白羊座和射手座	射手座和白羊座
运动的好处	不检索
减脂快的运动	减脂快的运动
和朋友一起的运动	减脂的双人运动
减脂的方法	不检索
减肥的方法	不检索
故宫门票	故宫参观需要票吗
故宫参观花费	不检索
故宫参观	不检索
故宫	故宫
故宫介绍	不检索
心理疾病	常见心理疾病
双相	双相
遇到双相的危害	不检索
抑郁症患者	不检索
如何帮助抑郁症患者	不检索
打羽毛球的好处	不检索
辽宁省营口市天气	不检索
羽毛球技术	羽毛球技术
打羽毛球的注意事项	不检索
打羽毛球戴口罩	疫情期间打羽毛球球
娃娃亲	娃娃亲
恋爱自由	恋爱自由政策
王梦二年级	小学二年级恋爱
什么年龄应该做什么事情	作业认真
谈恋爱的坏处	谈恋爱自由
谈恋爱的好处	不检索
喜剧电影	不检索
喜剧电影	电影类型
恐怖片	不检索
沈腾的喜剧片	沈腾的喜剧片
《西红市首富》	不检索
封笔	不检索
童子	不检索
童子	不检索
童子	童子大大。
太监和官吏的故事。	不检索
马连洼天气	心情不好的时候干什么
舒缓心情的音乐	不检索
流行音乐	流行歌手
林俊杰演唱会	林俊杰开了几场演唱会
林俊杰的歌	不检索
夏目友人帐	不检索
夏目友人帐美食	不检索
夏目友人帐	日本动漫
夏目友人帐	夏目友人帐治愈
夏目友人帐第几季	夏目友人帐第几季
夏目友人帐	不检索
蔬菜的营养价值	多吃蔬菜的优点
蔬菜的好处	青菜菜谱
蔬菜沙拉	不检索
蔬菜沙拉	不检索
蔬菜沙拉	不检索
北京站	不检索
北京站	不检索
北京景点	不检索
北京景点	北京景点
天安门	天安门
北京奥运会	不检索
美国的景点	不检索
美国的景点	美国的景点
纽约	纽约
纽约的景点	不检索
纽约的景点	美国的迪士尼
迪士尼	不检索
广东阳江哪里买口红	澳门出入境政策
阳江口红色号	不检索
口红颜色	澳门平价口红推荐
完美日记色号	不检索
阳江到澳门路线	阳江到澳门路线
张爱玲	张爱玲
近代上海上流社会	不检索
张爱玲的作品	张爱玲代表作
倾城之恋	倾城之恋
张爱玲三教九流	不检索
胡歌	不检索
胡歌	不检索
胡歌的作品	不检索
仙剑奇侠传胡歌	不检索
胡歌	胡歌在仙剑奇侠传一饰演什么角色？
胡歌	胡歌在仙剑奇侠传四里面饰演什么角色？
仙剑奇侠传四景天	不检索
滑冰	不检索
滑冰学什么	不检索
滑冰	不检索
羽生结弦	羽生结弦
羽生结弦	不检索
滑冰难吗	滑冰难吗？
可以和机器人对话的音箱	不检索
智能音箱品牌。	人工智能音箱
天猫精灵多少钱？	天猫精灵的价格。
天猫精灵多少钱	不检索
天猫精灵价格。	不检索
嘉兴云澜湾	嘉兴云澜湾
国庆旅游费用	云澜湾门票
云澜湾	云澜湾
云澜湾美食	云澜湾美食
云澜湾	不检索
陕西特产	不检索
中药吃多了会上火吗	不检索
中药为什么不能服用辛辣	服药为什么不能进食辛辣
中药为什么不能服用辛辣	不检索
辣椒能杀菌吗	辣椒能杀菌吗
感冒吃什么药	不检索
湖北省孝感市天气	湖北省孝感市天气
雨伞品牌	不检索
今天的天气	不检索
耐克鞋子	运动衣服国际品牌
耐克鞋子	nikejordan耐克乔丹品牌
耐克鞋子	不检索
led屏幕	点阵式led屏幕
led电子显示屏的原理	不检索
led电子显示屏原理	led电子显示屏什么原理
led显示屏的原理	不检索
电子技术的应用	不检索
小白猫	不检索
英短	英短
养猫的注意事项	养猫注意事项
猫能吃人类的食物吗	猫能吃人类的食物吗
猫能吃人的食物吗	不检索
蝴蝶兰	蝴蝶兰养护
蝴蝶兰价格	蝴蝶兰养护
蝴蝶兰浇水	蝴蝶兰浇水
合欢花	合欢花产地
合欢花中药	合欢花药方
退休的好处	不检索
养老的钱	不检索
养老金政策	最近国家养老金的政策
老龄化的影响	不检索
南方的养老院	不检索
电饭锅坏了	电饭锅故障
电饭锅电路板烧坏	电饭锅牌子
美的电饭锅	美的电饭锅
美的电饭锅	电器购买平台
苏宁电器	不检索
dota类的游戏	lol
玩游戏的坏处	人类一败涂地
人类一败涂地	人类一败涂地是怎么玩
人类一败涂地	我的世界
和平精英	不检索
歌手	不检索
姚贝娜	姚贝娜
武汉市	武汉市的特点
武汉市的景点	不检索
武汉黄鹤楼	不检索
山东德州	山东德州
山东德州景点	不检索
山东德州旅游	山东德州景点
济南景点	济南景点
济南景点	不检索
羽毛球	不检索
羽毛球日常锻炼	不检索
羽毛球拍品牌	什么牌子的羽毛球拍质量好
李宁羽毛球拍价格	李宁的羽毛球拍价格
李宁羽毛球拍价格	不检索
爬山的好处	不检索
中国可以爬的山	中国可以爬的山
中国可以爬的山	泰山
去爬泰山需要准备什么	去爬泰山需要准备什么
泰山附近的景点	泰山附近的景点
济南的鹊山	不检索
冰雪奇缘	冰雪奇缘
冰雪奇缘	不检索
冰雪奇缘2	冰雪奇缘2
冰雪奇缘2	冰雪奇缘插曲
艾莎的女王范	不检索
高铁站	高铁的优点
飞机的好处	飞机不舒服
飞机不舒服	飞机不舒适怎么办
喝柠檬水的好处	不检索
高铁站建成需要多久	不检索
干锅千叶豆腐	干锅千叶豆腐
干锅千叶豆腐	千叶豆腐是豆制品吗
干锅千叶豆腐	不检索
鱼豆腐	鱼豆腐是什么做的
鱼豆腐的原料	不检索
星座	不检索
八月份生日是什么星座	七八月份生日是什么星座
狮子座	不检索
狮子座的人	狮子座特征
狮子座的性格	不检索
演员出绯闻	不检索
郭麒麟	郭麒麟绯闻
郭麒麟绯闻	不检索
德云社演员	德云社演员
小岳岳歌曲歌词	不检索
中医开的中药	不检索
中药为什么不能服用	多囊卵巢综合症简称什么
多囊卵巢综合症	多囊卵巢综合症的病因
多囊卵巢综合症	多囊卵巢综合症要注意什么
多囊卵巢综合症	不检索
舒缓心情的电影。	不检索
治愈电影	治愈电影
《萤火之森》	《萤火之森》
《海蒂和爷爷》	不检索
《海蒂和爷爷》	不检索
《海蒂和爷爷》	《海蒂和爷爷》
澳门天气	澳门冷空气本轮
下雨天能做什么	下雨天运动家里
电影推荐	电影推荐
电影推荐	电影推荐小众
电影评分	不检索
空气炸锅	空气炸锅
空气炸锅薯条	烤箱薯条
空气炸锅价格	不检索
空气炸锅的功能	不检索
养生锅	不检索
期中考	不检索
中考成绩影响	不检索
中考分流	中考分流
中考分流	不检索
中考排名	不检索
温州天气	温州天气预报
温州天气	不检索
为什么一冷就不想工作	不检索
懒的原因	懒好处
懒的好处	不检索
懒的好处	不检索
抖音	不检索
抖音	不检索
怎么把短视频拍流畅	不检索
如何把短视频拍的更流畅	短视频剪辑软件
短视频剪辑软件	不检索
村上春树	村上春树作品
村上春树的作品	村上春树文字风格
村上春树的译本	林少华
村上春树的作品	许渊冲
许渊冲	许渊冲信达雅
写论文的肌肉僵硬	不检索
如何缓解肌肉僵硬	久坐的危害
如何保持思路	如何保持思路
做什么运动能保持思路	不检索
如何保持思路	不检索
中国的乒乓球队	中国的乒乓球队
马龙	马龙乒乓球
马龙	东奥会乒乓球
女乒乓球运动员	中国女乒乓球运动员
中国的乒乓球为什么这么厉害	中国的乒乓球为什么这么厉害呢
中国的乒乓球为什么这么厉害	不检索
家庭幸福的家庭	不检索
计划生育的危害	计划生育的影响
想孩子的家庭	不检索
父母离婚的孩子	单亲家庭孩子的问题
给孩子提供健康的成长环境	不检索
《神探夏洛克》的片段。	不检索
擅长捉弄的高木同学	擅长捉弄的高木同学。
擅长捉弄的高木同学	不检索
擅长捉弄的高木同学剧情	辉夜大小姐想让我告白
辉夜大小姐的恋爱头脑战。	不检索
生孩子的好处	不检索
奶粉的好处	不检索
奶粉品牌	奶粉品牌
美赞臣奶粉	美赞臣奶粉多少钱
美赞臣奶粉多少钱	美赞臣奶粉价格
婴儿奶粉品牌	不检索
黄山市天气	不检索
骑自行车的好处	不检索
骑自行车的好处	学骑自行车注意事项
黄山市天气	黄山市天气
黄山天气	不检索
结婚和恋爱的区别	结婚的什么
恋爱的好处	恋爱的感觉
结婚的好处	不检索
结婚的好处	不检索
结婚后的孩子	不检索
养宠物的好处	不检索
养宠物的好处	不检索
热带鱼的水温	鱼缸恒温
热带鱼的注意事项	热带鱼怎么养
养热带鱼的注意事项	不检索
物理专业	物理专业主要学什么
物理专业报考	不检索
学物理的好处	物理专业毕业后就职
毕业后做什么	不检索
大学里的个人时间	不检索
维生素d	维生素d补钙吗
维生素能通过饮食满足么	维生素能通过饮食满足吗
维生素片能服用吗	饮食均衡是否不用服用维生素片
科学的均衡饮食是怎样的	不检索
补充维生素的食物	不检索
短视频软件	很火的短视频软件
抖音	不检索
抖音	不检索
小红书	小红书的视频的分类
小红书视频	不检索
锡林郭勒景区	锡林郭勒景区
平顶山天气	天气
溜冰	锡林郭勒冰场
锡林湖冰场	肌肉记忆
溜冰	溜冰技巧
彭于晏	彭于晏的知名电影
彭于晏电视剧	彭于晏出道电视剧
彭于晏小时候减肥	彭于晏小时候减肥
彭于晏的手语	彭于晏听说电影
彭于晏	彭于晏出生时间
唐诗逸	唐诗逸
唐诗逸的民族舞	唐诗逸
唐诗逸	不检索
民族舞	不检索
b站民族舞	不检索
新电视	不检索
电视机发明者	电视机发明者
电视无声	电视无声定军山
电脑和电视的区别	不检索
电视现在还会不会被淘汰掉	不检索
大兴安岭旅游	大兴安岭周围景点
北京的景点	北京冬奥会时间和地点
北京冬奥会	北京冬奥会比赛地点
北京冬奥会门票	不检索
北京冬奥会门票	不检索
常州市交通	常州市交通
常州地铁	常州地铁
常州地铁	常州地铁
常州地铁	不检索
常州地铁	不检索
常州景点	常州游玩
学习的压力	不检索
小学数学口算	小学数学口算
小学数学口算	2乘4
小学数学口算	不检索
小学数学课外补课	不检索
番茄炒蛋	番茄炒蛋
番茄炒蛋	不检索
豆瓣小组	豆瓣下厨房小组
清蒸鲈鱼	清蒸鲈鱼
鱼活蹦乱跳	不检索
电视剧	不检索
《开端》	电视剧开端
无限流	不检索
《想见你》	电视剧想见你
电视剧的品味	不检索
作家	不检索
余华	余华的作品
余华在细雨中呼喊	余华在细雨中呼喊
余华	不检索
余华的作品	余华经典作品
996	996工作
互联网人的工作状态	不检索
互联网竞争	互联网加班
美国互联网竞争	互联网竞争
美国互联网公司	美国互联网公司有哪些
腿粗的裤子	不检索
腿粗的穿搭	不检索
黑色阔腿裤和什么衣服搭配	不检索
黑色阔腿裤和什么衣服搭配	不检索
穿短裙的好处	不检索
送女友什么生日礼物	送女友什么生日礼物
定制礼物	定制礼物
送女友什么生日礼物	化妆品都包括什么
口红选择部位	挑选口红
口红推荐	女孩子为什么喜欢口红
华为公司怎么样？	华为公司怎么样？
格力	格力公司怎么样
格力和华为的区别	不检索
华为的智能家居产品	不检索
格力的工资	不检索
硬盘的品牌。	硬盘内存多大
2t移动硬盘	2t硬盘价钱
2t硬盘价格	2t移动硬盘价钱
移动硬盘价格	不检索
关于硬盘的问题	不检索
为相亲发愁	不检索
择偶观	不检索
择偶观	择偶观
相信爱情	相信爱情
相信爱情	不检索
盐下多苦	盐下多了苦
人每天摄入的盐含量	人每天摄入的盐含量
吃盐的危害	不检索
糖分摄入量	糖分摄入量
喝奶茶的好处	不检索
剁椒鱼头	不检索
剁椒鱼头	剁椒鱼头
剁椒鱼头做法	剁椒鱼头做法
剁椒鱼头做法	剁椒鱼头用什么鱼
剁椒鱼头做法	不检索
老人常见病	老年人常见病
糖尿病	糖尿病如何治疗
糖尿病人打胰岛素	糖尿病人为什么要打胰岛素
糖尿病患者自己产生的胰岛素太少	不检索
糖尿病患者吃胰岛素的危害	不检索
英国历史剧	不检索
白王后	《白王后》
白王后	白王后很好看
白王后和爱德华四世的爱情	白王后和爱德华四世的爱情
《白公主》	《白公主》
《白公主》	不检索
乔家的儿女电视剧	不检索
乔家的儿女	乔家的儿女简介
乔家的儿女电视剧	不检索
乔家的儿女的演员	乔家的儿女演员表
乔家的儿女资源	不检索
玩游戏的危害	不检索
狼人杀	狼人杀
狼人杀怎么装无辜	不检索
狼人杀上帝	狼人杀上帝
狼人杀被查	不检索
最近上映的电影	最近上线电影
《长津湖》	《长津湖》
抗美援朝历史课	抗美援朝
新疆维吾尔自治区吐鲁番市	附近影院
上影国际影城	不检索
玩股票的好处	股票有风险吗
规避风险的方法	股票规避风险
理财的方法	理财方式
黄金	不检索
黄金价格	不检索
公众号收入	公众号阅读能提成吗
公众号赞赏	不检索
公众号打广告的好处	微信公众号能打广告吗
微信公众号的广告	不检索
微信公众号的收入渠道	不检索
地铁的优点	地铁
地铁是中国的发明吗	不检索
高铁	高铁
北京到雄安新区的高铁	不检索
北京到广州的地铁	不检索
故宫和爬长城	不检索
名著	名著
名著的分类	名著中的小说有什么
名著的分类	现代经典阅读小说
文学专业学什么	文学专业学怎么学
学文学的好处	不检索
从事什么工作？	不检索
迷茫的原因	不检索
老师的工作	成为老师需要什么？
普通话考试	普通话考试在几月份？
教师资格证考试时间	不检索
星座	不检索
处女座强迫症	处女座强迫症
天蝎座性格	天蝎座优点
处女座和什么星座的人最合得来	处女座
金牛和处女座的性格	不检索
音乐电影	不检索
《爱乐之城》	《爱乐之城》
《爱乐之城》	不检索
《爱乐之城》	不检索
《再次出发之纽约遇见你》	《再次出发之纽约遇见你》
《再次出发之纽约遇见你》	不检索
大国粮仓纪录片	大国粮仓纪录片
中国耕地这么少	中国耕地
缺耕地的原因	不检索
中国北方的耕地为什么这么少	不检索
中国的大型基建	不检索
唱歌的好处	今天天气
黄山市天气	不检索
唱歌的歌单	不检索
阿云嘎的歌	阿云嘎的歌
阿云嘎的歌	不检索
辅导班	不检索
古筝	不检索
家长可以给孩子报辅导班吗	父母报辅导班的坏处
孩子喜欢古筝	不检索
学习古筝的方法	学习古筝的渠道
承德二中历史	承德二中前身
承德二中建校历史	承德二中建校历史
承德二中软件	不检索
北京四中建校时间	北京四中建校初衷
承德二中历史	不检索
郑州市修理铺	河南省郑州市修理铺
郑州市购买新电视机	郑州市卖电器
pptv怎么样	不检索
tcl液晶电视	不检索
tcl液晶电视	不检索
牧羊犬	牧羊犬
牧羊犬市场价	牧羊犬的市场价
牧羊犬价格	不检索
牧羊犬生小崽	不检索
送朋友的宠物	不检索
粉底液推荐	粉底液推荐。
大牌粉底液价格	平价的粉底液。
卡姿兰大眼睛粉底液	不检索
卡姿兰粉底液多少钱	卡姿兰粉底液多少钱？
卡姿兰粉底液多少钱	不检索
最近的新闻	在哪里看新闻
最近的新闻	不检索
今天省内有什么事情发生	今天黑龙江省新闻
疫情	不检索
新冠病毒	新冠病毒发生时间
屯昌县旅游	不检索
海南旅游	海南旅游
五一假期海南旅游	不检索
旅行注意事项	不检索
旅行注意事项	旅游注意事项
旅游吃坏肚子	不检索
酸菜鱼怎么做	酸菜鱼
酸菜鱼做法	酸菜鱼菜谱
酸菜鱼做法	酸菜鱼
酸菜鱼做法	不检索
酸菜鱼做法	不检索
辣条的好处	不检索
卫龙辣条	买零食辣条最便宜的网站
卫龙辣条	不检索
卫龙辣条价格	卫龙辣条的价格
卫龙辣条价格	不检索
中秋节月饼	什么月饼好吃
莲蓉蛋黄月饼	莲蓉蛋黄月饼怎么做？
水是什么	水是什么
中秋节吃月饼的习俗	不检索
中秋佳节的庆祝方式	不检索
三沙市电影	三沙市电影院
《四海》和《长津湖2》	电影四海
长津湖电影	长津湖2决战水门桥
长津湖电影	不检索
学习中国特色的国防教育	不检索
军训防晒霜	不检索
军训防晒霜推荐	军训防晒霜推荐
碧柔防晒	不检索
军训防晒霜推荐	不检索
军训后皮肤变黑	不检索
干皮推荐的化妆品	干皮的护肤品
兰蔻清滢柔肤水的价格。	不检索
干性肌肤平价护肤品	干性肌肤的平价护肤品
兰蔻清滢柔肤水。	不检索
国际品牌	不检索
香港天气	香港特别行政区天气
香港天气	不检索
电视剧	不检索
推荐的电视剧	胡歌的仙剑奇侠传
仙剑奇侠传	仙剑奇侠传
昌江假期	不检索
昌江到三亚飞机	昌江三亚海南环岛
昌江到三亚路线	不检索
周末三亚的天气	三亚周末天气
三亚景点	不检索
长痘痘的原因	不检索
青春痘的注意事项	青春痘的注意事项
熬夜的危害	不检索
熬夜的危害	熬夜的危害
熬夜的危害	不检索
基金的风险	基金的风险
新手买基金的方法	新手买基金需要注意什么
新手买基金的方法	不检索
中欧医疗基金最近的态势	中欧医疗基金最近的态势
新手如何学习基金	如何学会购买基金
新手如何开始买基金	不检索
高中生活	不检索
小说人生	不检索
人生三大类	路遥人生
平凡的世界	不检索
人生的路遥	不检索
海南冬季天	海南省东方市天气
海南省最低温度	海南省最低温度
防晒的方法	防晒
椰子	海南椰子
海南椰子	不检索
《香蜜沉沉烬如霜》	《香蜜沉沉烬如霜》
杨紫邓伦合作电视剧	杨紫和邓伦合作电视剧
《花非花雾非雾》	《花非花雾非雾》
花非花雾非雾	不检索
邓伦《花非花雾非雾》	不检索
五一假期	不检索
广东省湛江旅游景点	广州附近旅游景点
广东省茂名旅游景点	中山市旅游景点
中山市景点	不检索
中山高铁	不检索
计算机专业学什么	不检索
c++	不检索
计算机专业毕业以后能当程序员吗	不检索
元宇宙研究	元宇宙技术
区块链技术	不检索
云南省玉溪市天气	不检索
云南省玉溪市景点	云南省玉溪市景点
云南省玉溪市景点	云南省玉溪市美食街
洪记凉米线	不检索
玉溪美食	不检索
赵丽颖	不检索
赵丽颖	不检索
赵丽颖	赵丽颖
赵丽颖	赵丽颖电视剧
赵丽颖的生日	赵丽颖离婚
冬奥会	不检索
武大靖	不检索
短道速滑	不检索
武大靖	不检索
武大靖	不检索
成为香奈儿	不检索
香奈儿的生平	可可香奈儿
简约优雅的香奈儿	香奈儿包2.55
香奈儿的香水	香奈儿5号
香奈儿5号	不检索
电视剧	电视剧
郭京飞姚晨	不检索
山海情	山海情
山海情导演	山海情导演
孔笙	孔笙作品
失恋的原因	不检索
失恋的原因	走出失恋的好方法
失恋的原因	朋友失恋了怎么安慰她
失恋的原因	不检索
努力工作的重要性	不检索
圆明园	圆明园面积
圆明园被破坏的原因	圆明园被破坏的原因
清朝的无能	不检索
新中国的伟大	不检索
转完圆明园的景点	北京景点推荐
甘肃省金昌市电影院	最近上映的电影
国外的电影	最近上映的国外电影
《狮子王》	不检索
《狮子王》	不检索
附近购物中心	不检索
油爆大虾	油爆大虾怎么做
做菜的好处	不检索
家常菜	好吃的家常菜
红烧茄子	不检索
海口美食	不检索
散步的好处	散步的好处
散步的好处	散步需要注意的地方
散步的好处	不检索
散步的好处	不检索
附近的花	不检索
五月天的歌	不检索
五月天的歌	五月天作品
五月天2021年演唱会	五月天2022年演唱会时间
五月天演唱会	不检索
五月天演唱会	不检索
六级考试	不检索
六级考试	六级考试经验
六级词汇	六级词汇书
六级词汇	不检索
六级词汇	不检索
吉林省白城市的景点	白城市的公园
吉林省白城市天气	今日天气
吉林白城市天气	不检索
姜糖水	喝姜糖水的额好处
吉林白城市天气	不检索
马丁靴	马丁靴
马丁靴搭配裤子	马丁靴搭配裤子
铅笔裤和工装裤的区别	不检索
马丁靴贵	马丁靴价格贵
马丁靴多少钱	不检索
白敬亭	白敬亭
《开端》	不检索
《明星大侦探》	《明星大侦探》
张若昀	不检索
张若昀	张若昀
张显宗	不检索
当记者的好处	当记者
当记者需要什么	当记者
当记者的好处	当记者
当记者的好处	不检索
当记者的家人	不检索
穿搭颜色搭配	穿搭颜色搭配
浅蓝色的牛仔裙配什么上衣	浅蓝色的牛仔裙配什么上衣
浅卡其色上衣	不检索
白色卫衣搭什么下装	白色卫衣搭什么下装
白色卫衣搭什么下装	不检索
北京的景点	不检索
北京美食	北京美食
北京烤鸭	不检索
北京特产	北京特产
北京的糕点品牌	不检索
宣城天气	不检索
山桃花	茶花
相机拍花	拍花的技巧
九宫格构图	九宫格构图
九宫格构图	不检索
五月天的歌	五月天的歌
五月天的组合	五月天组合
五月天和信乐团	五月天和信乐团
五月天的歌	五月天的音乐风格
五月天的歌	不检索
锅包肉	锅包肉
锅包肉	不检索
做锅包肉的步骤	不检索
里脊肉做法	不检索
锅包肉怎么做	不检索
结婚的好处	不检索
结婚的年龄	结婚法定年龄
彩礼	彩礼
彩礼	不检索
情投意合的恋爱	不检索
嘉兴什么中学好	嘉兴比较好的中学
嘉兴市一中文科理科哪个强	浙江高考分文理吗
嘉兴市中考分数线	嘉兴一中中考分数线
中考文科理科哪个强	不检索
进一中的门槛	不检索
星座	不检索
星座	不检索
射手座	射手座
射手座	射手座
射手座	不检索
处女座	处女座
元宇宙的话题	不检索
元宇宙	什么是元宇宙
元宇宙怎么赚钱	元宇宙赚钱
元宇宙的市场前景	不检索
元宇宙的弊端	元宇宙弊端
元宇宙的弊端	不检索
做菜的坏处	做菜的好处
做饭后洗碗	不检索
吃外卖的危害	吃外卖的危害
做饭的好处	不检索
做饭的好处	不检索
空间站	中国空间站
空间站的名字。	空间站
空间站	空间站
空间站	国际空间站寿命
国际空间站2021年寿终正寝	不检索
网易云音乐版权	不检索
周杰伦的歌	周杰伦
喜欢听轻音乐的朋友可以下载咪咕音乐	不检索
韩语歌	不检索
韩国女团	韩国女团
喜剧电影	不检索
周星驰	周星驰
大话西游紫霞仙子	不检索
香港影视业大繁荣的时期	不检索
杨千嬅	杨千嬅
乒乓球	不检索
哪个牌子的乒乓球拍好用	质量好的乒乓球拍品牌
深圳哪里可以买到斯帝卡乒乓球拍	在那里买乒乓球拍
李宁牌乒乓球拍	不检索
李宁牌的乒乓球拍	不检索
星座可信吗	星座该不该相信
魔羯座和1月份的摩羯性格	魔羯座12月份和1月份出生的性格有区别吗
魔羯座性格	不检索
魔羯座的性格	陶白白
魔羯座为什么单身	魔羯座为什么单身
魔羯座性格	巴纳姆效应
兴趣爱好	兴趣爱好
背古诗的好处	不检索
喜欢看古诗的好处	不检索
附近的国学班	不检索
古诗词朗诵	古诗词大会
苏炳添	苏炳添
苏炳添的工作	苏炳添老师
刘翔	中国短跑名将
培养田径运动员的方法	世界短跑名将
博尔特	不检索
怀化市天气	今天的天气
怀化市体育馆	怀化市的体育馆
羽毛球装备	打羽毛球的装备
运动鞋脚上滑	不检索
羽毛球拍	不检索
羽毛球比赛	不检索
延时摄影	延时摄影
延时摄影	延时摄影
延时摄影	延时摄影
延时摄影的应用	延时摄影
延时摄影需要的器材	不检索
养花的好处	家里养花药用植物
降糖草	降糖草家里能养吗
降糖草	不检索
降糖草使用禁忌	降糖草使用禁忌
老人高血压	不检索
北京冬奥开幕式	北京冬奥总导演
2008年奥运会开幕式	2008年奥运会开幕式有多好
2008年奥运会的奖牌	2008年奥运会我国奖牌数
冬奥烟花寓意	不检索
黄山冬奥会	不检索
战狼2	战狼2
退伍的新闻	退伍不褪色的新闻
战狼2	战狼2体现了什么
吴京手举国旗	吴京手举国旗
中国的实力	不检索
战狼2	不检索
胖的原因	不检索
男女比例	不检索
怎么让男朋友眼前一亮	不检索
减肥的方法	减肥的方法。
吃肉的危害	减肥的人能吃肉吗？
武威市一中建校时间	不检索
兰州天气	兰州接下来一个月的天气
兰州大学校徽	兰州大学校徽是什么样子
武威市天气	不检索
武威美食	不检索
感冒的原因	感冒怎么办
天气变冷	天气
凉山彝族自治州天气	不检索
感冒吃什么药	不检索
润喉糖	不检索
北京邮电大学	不检索
北京邮电大学	不检索
教师的工资	教师工资有多低
教师工资	教师的精神幸福
教师的精神幸福	不检索
烤箱小点心	布朗尼
戚风蛋糕食材	戚风蛋糕做法
戚风蛋糕做法	戚风蛋糕做法
戚风蛋糕做法	不检索
布朗尼甜品	烤箱甜品
青豌豆	不检索
青豌豆零食	青豌豆价钱
上海迪士尼乐园青豌豆	上海迪士尼乐园青豌豆
青豌豆零食	青豌豆零食
厨房小白	厨房小白
上海迪士尼乐园	不检索
好硬的菜	不检索
菜系代表菜	八大菜系
佛跳墙	佛跳墙有多难做
佛跳墙老师	不检索
佛跳墙怎么做	不检索
教师资格证考试	教师资格证笔试时间
教师资格证考试时间	教师资格证考试ke'mu
教师资格证面试可以染发吗	教师资格证面试能染发么
教师资格证面试	不检索
教师资格证去景点	不检索
网络小说	不检索
偷书贼作者	偷书贼
国外的小说	不检索
日本的治愈小说	日本的治愈小说
日本的治愈小说	不检索
快递的种类	不检索
淘宝的衣服	不检索
快递	快递
快递的仪式感	飞鸽传书
快递是哪个国家发明的	快递是哪个国家发明的呢
快递是哪个国家发明的	不检索
伊藤美诚	孙颖莎
伊藤美诚	伊藤美诚实力
伊藤美诚	不检索
伊藤美诚的发球的表情包	不检索
孙颖莎打伊藤美诚的比赛	不检索
星座	不检索
阳历6月18日是什么星座	阳历6月18是什么星座
狮子座	双子座和狮子座匹配指数
上升星座	6月18日的上升星座
星盘算出来的绝对准吗	不检索
退休养老金	养老金女性
退休养老金	女性退休养老金
退休手续	女性养老金手续
社保局的工作	不检索
退休手续	不检索
六级考试	不检索
六级考试	不检索
六级报名时间	六级报名
六级考试时间	不检索
六级考试时间	不检索
六级app	不检索
b站up主	不检索
国风舞蹈	不检索
洛神水赋	国风舞蹈洛神水赋
《洛神水赋》完整版	不检索
河南卫视端午奇妙游	不检索
送女友口红	口红品牌
兰蔻口红推荐	兰蔻口红推荐
兰蔻丝绒菁纯唇膏价格	不检索
实体店和网上买的口红质量有区别吗	不检索
兰蔻丝绒菁纯唇膏多少钱？	不检索
旅行的意义	不检索
青岛海边	青岛海边
青岛疫情	青岛疫情
青岛疫情	厦门疫情
厦门的景点	不检索
上海的海边	不检索
考研录取	不检索
考研专业	考研专业
今年考研分数线	考研分数线
考研专业课	翻译硕士专业课
考研专业课复习时间	不检索
处女座	巨蟹座和处女座
处女座和巨蟹座的爱情	星座可信吗
当心情不好的时候可以用星座来占卜	不检索
和处女座比较不合的星座	和处女座比较不合的星座
处女座的女生不太好相处	处女座的女生不太好相处原因
处女男	不检索
考试紧张	考试紧张
考试前忘记背的知识点	不检索
考试前几个小时是谁考了第一名	不检索
考了多少名	不检索
考试复习	考试复习方法
《乐队的夏天》	《乐队的夏天》
《乐队的夏天》	不检索
刺猬乐队	刺猬乐队
火车驶向云外，梦安魂于九州	不检索
《火车驶向云外，梦安魂于九州》的歌词	不检索
《火车驶向云外，梦安魂于九州》的歌词	不检索
交通银行理财	交通银行理财
安增益	安增益31天
银行定期存款利率	银行定期存款利率
交通银行大额存单	交通银行大额存单
交通银行大额存单	不检索
学中医的好处	不检索
针灸课程	不检索
针灸是用针刺治疗吗	针灸
针灸是怎么治疗	不检索
针灸的作用	不检索
为什么单身	母胎solo
单身的原因	年龄焦虑
单身的原因	不检索
宅女不爱出门	爱情
男生喜欢女生的原因	不检索
男生喜欢女生的原因	不检索
机器人有可能取代人类吗	机器人会取代人类吗
机器人会自己进化出意识吗	不检索
西部世界	西部世界电视剧
西部世界	不检索
机器人有可能产生自主意识吗	机器人有可能产生自主意识吗
吃水果的好处	不检索
吃水果的好处	不检索
苹果的好处	吃苹果的好处
苹果一天最多吃几个	不检索
苹果的好处	不检索
苹果看望病人	苹果看望病人
布偶猫	布偶猫的特点
布偶猫的性格	不检索
养猫的好处	不检索
养猫的注意事项	养猫要注意的地方
养猫的注意事项	不检索
旺旺大礼包	旺旺大礼包产品
浪味仙	浪味仙口味
浪味仙	不检索
贵州土豆片	零食贵州土豆片
戚薇的零食	不检索
交通的好处	交通的设计
交通规划	不检索
堵车原因	堵车
堵车原因	不检索
堵车原因	不检索
陕西省铜川市天气	陕西省天气预报
陕西省铜川市天气	不检索
东北人怎么扛过去	东北人保暖的方法
炕	炕
东北炕	不检索
学跳舞的好处	民族舞
秧歌舞	不检索
kpop舞蹈	kpop舞蹈
kpop舞蹈	不检索
少女时代	少女时代
过年吃胖	过年胖
过年运动	运动减肥
跳绳受伤	跳绳受伤
练腹肌的方法	练腹肌的动作
平板支撑运动	不检索
科幻电影	科幻电影
《复仇者联盟》	不检索
奇异博士	奇异博士
哈利波特	哈利波特
哈利波特	不检索
哈利波特	不检索
过年添衣	不检索
附近的商场	云南省文山壮族苗族自治州的购物中心
文山交通	不检索
淘宝	可以购物服装的软件
小红书穿搭博主	不检索
言情小说	不检索
墨香铜臭	墨香铜臭
魔道祖师翻拍	不检索
魔道祖师的扮演者	不检索
王一博	不检索
玩游戏的好处	流行的手机游戏有什么
玩游戏的坏处	玩手机游戏的危害
微博	不检索
看手机眼睛不舒服	看手机眼睛疼怎么办
看手机的危害	不检索
大学生就业难吗	不检索
大学生就业	大学生就业
公共管理学专业就业	大学生就业
公务员工作	不检索
找工作的注意事项	公务员
凉菜的种类	凉菜口味
凉菜的做法	凉菜做法
除了凉菜的菜品还有哪些	出门的川菜
川菜	不检索
做厨师的注意事项	不检索
常见的常见病	常见病
电子产品用多了容易患近视	不检索
过年压力	如何应对压力
睡眠的重要性	如何有高质量睡眠
失眠的危害	不检索
刘奕君	不检索
电视剧开端	电视剧《开端》主演刘奕君
《扫黑风暴》刘奕君	《扫黑风暴》刘奕君
《父母爱情》刘奕君姐夫	《父母爱情》欧阳姐夫
《父母爱情》	不检索
养花的好处	养花的好处
养花的植物	不检索
室内绿植物	室内绿植物
红掌	红掌
室内养花的注意事项	不检索
胡歌剧荒	不检索
胡歌	胡歌
胡歌电视剧	胡歌演的电视剧
杨延昭	杨延昭
彭于晏	不检索
脱单	不检索
送闺蜜的祝福	送闺蜜的恋爱祝福
送闺蜜的祝福	恋爱建议
被泡走的原因	不检索
男女比例	不检索
世界名著	好看的世界名著有哪些
鲁滨逊漂流记	鲁滨逊漂流记
鲁滨逊漂流记	不检索
鲁滨逊漂流记	不检索
鲁滨逊漂流记作者	鲁滨逊漂流记的作者是
最近的水果	云南省现在的水果
西番莲和榴莲	西番莲
百香果	不检索
吃榴莲的好处	不检索
武林外传榴莲	武林外传榴莲臭豆腐蛋
武林外传榴莲价格	挑榴莲的技巧
藏红花	藏红花
藏红花的功效	藏红花功效
藏红花的功效	藏红花使用方法
孕妇可以吃藏红花吗	谁不能服用藏红花
藏红花不能乱吃	不检索
无聊的时候看小说	不检索
有趣的小说	有趣的小说推荐
《我在少林签到万年》	《我在少林签到万年》的介绍
森萝万象	不检索
《我在少林签到万年》	不检索
谷爱凌	谷爱凌冬奥会
谷爱凌妈妈	谷爱凌妈妈北大
谷爱凌	不检索
平昌冬奥会金博洋	不检索
平昌冬奥会金博洋训练	不检索
冬奥会	解说王蒙短道速滑
花滑	花滑羽生结弦
谷爱凌	谷爱凌
谷爱凌	不检索
雅思和gre	不检索
软件工程专业	软件工程
软件工程专业	不检索
女程序员	女程序员
赵洁琼	不检索
软件工程专业毕业后可以从事什么工作？	不检索
邵阳市	邵阳
邵阳市	自驾游的优势
邵阳景点	邵阳市
邵阳景点	邵阳市景点
丹霞峰林	丹霞峰林
李世民是唐朝的开国皇帝吗？	唐朝开国皇帝
李世民的功绩	李世民的功绩
李世民的军事实力	李世民的军事实力
李世民的军事实力	不检索
开国的前几个帝王	不检索
毕业的意义	不检索
考研	不检索
人民大学	中国人民大学
北方的气候	北方干燥怎么办
考研的注意事项	不检索
重庆景点	附近的景点
欢乐谷	重庆欢乐谷
北京欢乐谷	北京欢乐谷
亚特兰蒂斯	亚特兰蒂斯是什么
亚特兰蒂斯传说	不检索
重庆欢乐谷	重庆欢乐谷
百合花开	百合花插花
多肉养护	多肉养护
多肉受欢迎	多肉受欢迎
猪笼草	猪笼草寓意
天气	不检索
膨化食品和油炸食品的区别	不检索
膨化零食和油炸有区别吗	膨化零食
膨化零食的油脂含量	不检索
膨化食品	膨化食品健康吗
膨化食品	不检索
家里养花的好处	不检索
学养花的方法	不检索
阳台养花	养花
移植花枝	移植花枝
移植的土壤	不检索
硕士研究生就业	硕士研究生
研究生的学习方法	硕士研究生的分类
博士进公司还是进编制	毕业的就业方向
汉语言文学老师	汉语言的就业方向
教师的成就感	教师的成就感
教招考试	不检索
吃什么水果的好处	苹果的功用
芒果的好处	芒果的产地
芒果的好处	不检索
人参果	人参果是什么
人参果的味道	不检索
青岛景点	青岛景点推荐
崂山的自然风景	不检索
登山注意事项	登山注意事项
登山注意事项	不检索
爬山的好处	不锻炼的危害
看电影的好处	不检索
看电影的好处	谈恋爱看什么电影？
新上映的爱情片	情侣可以看恐怖片吗？
情侣看恐怖片	不检索
情侣看恐怖片	不检索
大金毛	不检索
边牧	边牧
边牧性格	不检索
边牧	边牧不听话吗
边牧性格	不检索
柚子	不检索
北京买房	北京五棵松和八宝山站买房多少钱
非北京户口怎么可以在北京买房	非北京户口怎么可以在北京买房
外省户口在北京买了社保，在老家退休后怎么办？	外省户口在北京买了社保，在老家退休后怎么办
买个两居室需要花费多少钱？	不检索
在北京买房孩子教育可以解决嘛	不检索
阿里地区歌手	不检索
张靓颖	不检索
画心	《画心》歌词
张靓颖的歌	张靓颖
张靓颖的歌	不检索
欢乐喜剧人	欢乐喜剧人
欢乐喜剧人贾玲	不检索
贾玲张小斐	贾玲张小斐演的春晚小品
婆婆妈妈片段	婆婆妈妈小品最搞笑片段
张小斐	不检索
毛衣的款式	克莱因蓝
克莱因蓝	不检索
克莱因蓝毛衣	怎么提高穿搭品味
穿搭的方法	不检索
商场	不检索
胭脂扣张国荣梅艳芳	胭脂扣
张国荣的作品	张国荣作品
张国荣的作品	张国荣作品
梅艳芳	梅艳芳地位
梅艳芳的作品	不检索
宇航员回回舱	不检索
宇航员需要做哪些训练	宇航员要接受哪些训练
宇航员的训练周期	中国宇航员要接受多久训练
宇航员的培养周期	不检索
宇航员的训练周期	不检索
星座可信吗	星座可信吗
摩羯女	摩羯女
水瓶男	水瓶座男生
摩羯女和水瓶男的恋情	摩羯女和水瓶男的恋情
摩羯女和水瓶男的爱情	不检索
爱豆	不检索
爱豆的才气	既是爱豆也是歌手的人
泰妍	不检索
蔡徐坤	蔡徐坤的音乐作品
《重生》	不检索
穿搭的衣服。	不检索
学穿搭的好处	穿搭小白从什么开始学？
胖的原因	胖人的穿搭。
瘦身的衣服。	不检索
大码模特	不检索
第五人格氪金	第五人格氪金
第五人格	第五人格
第五人格的3d游戏	第五人格3d
监管者还是求生者	监管者还是求生者
第五人格	第五人格可以和朋友一起玩吗？
第五人格	不检索
北京冰雹	北京冰雹
冰雹	易车横评冰雹
车内温度	不检索
焦作冰雹	焦作冰雹
焦作冰雹	不检索
鲁迅	鲁迅
鲁迅	鲁迅作品
《阿长与山海经》	不检索
闰土	少年闰土
《阿长与山海经》	不检索
章子怡的作品	章子怡作品
《艺伎回忆录》	《艺伎回忆录》时长
巩俐	《艺伎回忆录》
美瞳	灰色美瞳
艾乐视冰糖果灰	不检索
劲椎病	劲椎病
劲椎病	拉萨市治疗劲椎病的医院
拉萨市人民医院	拉萨市人民医院
拉萨市人民医院挂骨科	拉萨市人民医院如何就诊
拉萨市人民医院	拉萨市明天天气
被猫挠	不检索
被猫挠	被猫挠
被猫挠	被猫挠
被猫挠	不检索
济南市天气	济南天气
宣城天气	安徽宣城天气
宅家的生活	不检索
宅家运动	宅家运动
在家运动的好处	不检索
家里的老人	不检索
双一流	双一流学科是什么意思
双一流专业	北京工业大学双一流学科
双一流和985211一样么？	双一流和985211一样么？
双一流和985211一样么？	不检索
985211	不检索
历史双学位	不检索
历史的课程	喜欢历史的好处
乾隆时期的历史故事	乾隆时期的历史故事
乾隆六下江南	不检索
微服私访	不检索
胃疼的原因	不检索
胃药	胃药
喝中药的好处	胃病中成药
胃药	不检索
胃病为什么这么严重	不检索
胃病患者挂号信	不检索
美人无泪	美人无泪
皇太极和海兰珠的故事	皇太极和海兰珠的历史
清朝历史有趣的故事	清朝历世上有名的皇上爱情故事
顺治董鄂妃	顺治董鄂妃电视剧
顺治和董鄂妃的故事	不检索
穿搭	穿搭技巧
最近流行的穿搭	不检索
法式穿搭	法式穿搭
穿搭博主	穿搭博主
穿搭博主chiaraferragni	不检索
粉底液推荐	粉底液
nars奇迹粉底液	不检索
李佳琦直播	口红一哥李佳琦
李佳琦直播	李佳琦直播
化妆品价格	不检索
宁夏小吃	宁夏的特色小吃
宁夏美食	宁夏的羊肉
宁夏羊肉	宁夏景点
沙坡头	不检索
沙坡头	宁夏旅游旺季
哈尔滨年	不检索
哈尔滨天气	哈尔滨天气
哈尔滨天气	哈尔滨天气
哈尔滨天气	不检索
哈尔滨天气	不检索
教师资格考试	2022年考教资的时间
当老师的好处	当老师的条件
教师资格证	不检索
教师资格证考试时间	不检索
教师资格证	不检索
今天的世界是什么样子的	不检索
元宇宙	元宇宙
头号玩家	头号玩家
vr游戏	vr
元宇宙	不检索
元宇宙	不检索
喜欢的运动	常见的运动
乒乓球运动员	不检索
张继科	张继科
张继科的恋情	张继科恋情
张继科	张继科什么时候退役
为什么重庆会成为直辖市	不检索
重庆行政区划面积	重庆为什么设直辖市
重庆原来设的直辖市	什么时候设立的直辖市
重庆为什么不能和京津沪相提并论	重庆发展
轻轨穿楼	重庆轻轨经过楼房吗
项链品牌	项链品牌
施华洛世奇项链	不检索
施华洛世奇项链	施华洛世奇项链
施华洛世奇首饰	首饰品牌
施华洛世奇项链	不检索
工资的投资收益。	不检索
银行理财产品	银行理财产品
银行理财产品	不检索
银行的利率	定期存款利率最高的银行
银行理财产品	不检索
单反拍夜景的技巧	不检索
噪点多的原因	为什么单反拍夜景发黄
为什么单反拍夜景就满屏噪点	单反拍夜景为什么噪点多
感光度高的相机	感光度高导致的噪点怎么办
摄影玩多了怎么办	不检索
山东樱桃	山东樱桃
樱桃怎么清洗	不检索
樱桃价钱	不检索
樱桃做的食品	不检索
樱桃果酱怎么做	樱桃果酱怎么做
国外名著	不检索
国外的批判现实主义小说。	国外的批判现实主义小
英国的名著	不检索
英国的小说	英国的批判现实主义小说。
美国的小说	美国的批判现实主义小说。
软件工程专业学什么	软件工程专业学什么？
软件工程学什么课程？	软件工程学什么课程？
软件工程学什么课程？	不检索
软件工程的电脑配置	不检索
软件工程四。	不检索
黑龙江省鸡西市天气	最近天气
明天天气	本地明天天气
鸡西市天气	不检索
风筝朋友	不检索
烤肉	烧烤烤肉
江门水果	江门水果
江门香蕉价格	江门香蕉价格
江门香蕉价格	不检索
拔丝香蕉	不检索
拔丝香蕉	不检索
蒙太奇手法	蒙太奇手法的含义
蒙太奇	蒙太奇手法特征
蒙太奇手法	不检索
电影蒙太奇	不检索
电影蒙太奇	不检索
swich是什么	switch
switch	switch功能
switch价格	switch价格
switch价格	不检索
switch价格	不检索
mac生姜高光。	mac生姜高光。
mac生姜高光价格。	mac生姜高光的价格。
mac生姜高光价格。	不检索
上海哪里有卖高光的	不检索
mac生姜高光价格	不检索
高数挂科怎么办	挂科怎么办
修证	不检索
高数挂科怎么办	如何学习高数
高数做题方法	大学高数的学习方法
学习高数的方法	不检索
无聊的时候看电影	无聊的时候干什么
好看的电影	电影推荐
张艺谋	张艺谋
张艺谋代表作	张艺谋代表作
张艺谋作品	张艺谋作品
韩国bts	韩国bts
bts的歌	韩国bts专辑
网易云会员多少钱	网易云会员多少钱
网易云会员多少钱	网易云会员多少钱
网易云会员多少钱	不检索
《我是歌手》	让子弹飞
让子弹飞电影	饮食男女
吃鱼的好处	李安
江西九江市	不检索
江西九江市	不检索
谷爱凌	谷爱凌
滑雪注意事项	湖南滑雪场
滑雪注意事项	滑雪初学者技巧
学滑雪的方法	不检索
滑雪装备	滑雪装备
新疆维吾尔自治区	新疆维吾尔自治区
魔兽世界	不检索
魔兽世界	魔兽世界
魔兽世界	不检索
魔兽世界辅助职业	魔兽世界奶骑职业
魔兽世界奶骑	不检索
长胖的原因	减肥运动
跳绳的好处	跳绳跳操膝盖
跑步脚踝痛	跑步脚踝
北京骨科医院	骨科医院北京
北京骨科医院	不检索
中国航天技术的成就	不检索
中国航天技术的发展	中国航天技术什么时候起步的
中国航天技术的发展	不检索
中国航天技术的发展	中国航天已经取得了哪些成果
《神州飞天-中国航天的成就与展望》	不检索
睡前不要喝水的原因	为什么睡前不要喝水
一天喝多少水	一天喝多少水
早上空腹喝多少水	不检索
早上喝多少水	不检索
马克杯和保温杯的区别	不检索
金华天气	不检索
炖汤费时间	老火汤
排骨汤	排骨汤做法
金华天气	浙江金华菜市场最大
金华市兰溪门菜市场	不检索
在家做饭	不检索
家常菜	家常菜
红烧肉	不检索
鸡肉怎么吃	鸡肉美食
红烧肉和辣子鸡的区别	不检索
华语歌手	华晨宇代表作
《烟火里的尘埃》	歌曲我管你好听在哪
华晨宇群魔乱舞	不检索
周杰伦	不检索
周杰伦	不检索
计算机专业就业前景	不检索
计算机专业就业岗位	计算机专业毕业生就业
软件研发岗位	软件研发岗位辛苦吗
计算机专业就业岗位	不检索
计算机专业就业前景	计算机专业就业前景如何
穿搭app	穿搭博主
穿搭app	穿搭app
穿衣助手app	穿衣助手app
时尚博主	穿衣助手app
穿搭app	懒得学习穿搭
流行音乐	流行音乐
流行音乐	邓紫棋泡沫
流行音乐的种类	音乐的类型
流行音乐的定义	流行音乐的影响力
古典音乐	不检索
相信音乐的人	不检索
什么都不会做	不检索
叫外卖的好处	不检索
东北家常菜	东北家常菜代表
东北家常菜	地三鲜
地三鲜	地三鲜怎么做
地三鲜	地三鲜怎么做
自拍的技巧	自拍姿势
自拍的理论知识	美颜app
修图	不检索
拍立得相机	富士拍立得相机
富士拍立得相纸	拍立得相纸
肖邦最经典的钢琴曲	肖邦最经典的钢琴曲
肖邦的《第二钢琴协奏曲》	肖邦的《第二钢琴协奏曲》
天才钢琴作曲家	天才钢琴作曲家
肖邦的钢琴曲	钢琴曲
《蓝色多瑙河》的作者	《蓝色多瑙河》作者
鳄鱼	宠物鳄鱼
蛇	宠物蛇
猫猫狗狗	不检索
蚂蚁是什么鬼	不检索
蚂蚁	不检索
鲁迅	鲁迅作品
鲁迅的本名	鲁迅
祥林嫂出自哪一篇	祥林嫂出自哪一篇
闰土刺	闰土刺出自哪一篇
闰土刺	不检索
玩股市的好处	新手玩股市
学炒股的方法	新手炒股学习
新手学炒股	不检索
新手学炒股的途径	不检索
新手学炒股	不检索
文昌美食	文昌美食
文昌景点	文昌景点
会文十八行	会文十八行
会文十八行	不检索
文昌市美食	不检索
历史报考	历史报考
历史老师	不检索
历史就业	历史就业
历史专业的就业方向	不检索
历史专业方向	历史方向
云南省昭通市天气	云南省昭通市天气
云南省昭通市天气	不检索
书	《解忧杂货店》
莫言	莫言
最近剧荒	不检索
龙岩夜市	不检索
福建美食	福建美食
焖豆腐	焖豆腐
晚上吃油腻食品	晚上吃油腻食品
福建美食	不检索
跑步的方法	不检索
提高跑步耐力的方法	提高跑步耐力的方法
跑步缺乏动力	跑步缺乏动力怎么办
跑步的好处	不检索
跑步的好处	不检索
螺蛳粉	螺蛳粉
螺蛳粉	螺蛳粉为什么臭
臭豆腐	臭豆腐为什么臭
臭豆腐的臭味	不检索
柳螺蛳粉	吃螺蛳粉的好处
螺蛳粉的营养价值	不检索
东北人去海南	海南的好处
临高县	临高县
临高县	临高县
临高县景点	临高县景点
临高县美食	临高县美食
小时候的东西	不检索
服装设计师	不检索
产品设计师	产品设计师
产品设计师薪水	产品设计师薪水
金华市的薪水	不检索
男女比例	篮球运动
篮球运动相关的话题	nba
nba	nba
nba	nba
nba	nba
乔丹	不检索
四川省攀枝花市天气	四川省攀枝花市天气
攀枝花市购物	不检索
买东西的方法	不检索
华为耳机	华为耳机
华为耳机在人多的地方佩戴使用影响音质吗	华为耳机
成都哪里有卖耳机的	不检索
银行现在发展的怎么样	不检索
银行的发展	不检索
网络银行	网商银行
网商银行	不检索
网商银行	网商银行
网商银行	不检索
艾灸的好处	艾灸
艾灸的好处	不检索
艾灸的方法	艾灸怎么灸
艾灸的作用	艾灸有什么用
艾灸的作用	不检索
周口天气	周口天气
穿牛仔裤的好处	被冻到不良影响
牛仔裤的品牌	牛仔裤
喇叭裤的流行	喇叭裤
周口商场	周口商场
润德商场	不检索
玩游戏的好处	不检索
王者荣耀	不检索
天龙八部	天龙八部手游
天龙八部氪金	天龙八部氪金
天龙八部游戏	不检索
晚上开空调睡觉皮肤变干	不检索
皮肤起皮	皮肤起皮怎么办
冬天用什么面霜	好用的面霜
面霜品牌。	不检索
面霜的牌子。	面霜涂抹手法
阿拉尔市天气	不检索
出门的注意事项	不检索
四大名著	四大名著是哪些
西游记	《西游记》
西游记	不检索
阿拉尔市天气	不检索
沈阳航空航天大学	沈阳航空航天大
沈阳航空航天大学	不检索
沈阳航空航天大学	沈阳航空航天大学地址
沈阳航空航天大学	沈阳航空航天大学王牌专业
飞行器制造工程研究方向	飞行器制造工程研究方向
飞行器制造工程专业	不检索
百年孤独	不检索
百年孤独简介	百年孤独人物有多少
百年孤独上校	百年孤独上校
百年孤独名句	百年孤独名句
百年孤独名句	百年孤独名句
海口天气	海南海口天气
电影阿甘正传	不检索
阿甘正传	罗伯特泽米吉斯
阿甘正传	不检索
阿甘正传	你好李焕英
英语复习	不检索
6级考试	cet-6
6级考试	6级复习
英语考试	不检索
找工作的好处	不检索
自己做饭	不检索
辣椒炒肉	不检索
辣椒炒肉	不检索
做饭的好处	做饭软件
菜谱美食	不检索
国漫	不检索
国漫的优点	不检索
日漫的配音员。	不检索
jojo奇幻冒险	jojo的奇幻冒险。
jojo的反派口头禅	jojo啊的奇妙，冒险中的反派的口头禅。
文昌市天气	文昌市天气
文昌天气	不检索
腰肌劳损膏药	不检索
扎针疼吗	针灸疼
针灸腰肌劳损	针灸腰肌劳损
针灸的好处	不检索
跳槽去哪一家公司	移动公司
移动公司	不检索
互联网公司压力	不检索
薪资	薪资比较高的行业
acca考试时间	不检索
淮南市景点	淮南市
淮南	淮南市
淮南美食	淮南美食
淮南景点	淮南景点
淮南市景点	淮南市景点
喜欢的明星	喜欢的流量明星
鹿晗恋情	不检索
鹿晗迪丽热巴	鹿晗迪丽热巴综艺
鹿晗迪丽热巴	不检索
鹿晗和迪丽热巴的绯闻	不检索
年关疫情	年关疫情严重
年关疫情	疫情官方消息渠道
疫情期间，如何做好防护	疫情期间，如何做好防护
哈尔滨疫情	不检索
哈尔滨疫情	不检索
化妆品推荐	大牌化妆品
海蓝之谜的乳霜和娇兰的精华油。	不检索
平价护肤品推荐	精华油
水乳推荐	不检索
雅诗兰黛精华油	不检索
ps5主板	ps5游戏
战神4	战神4
战神4剧情	ps5巫师3
netflix巫师	巫师netflix
巫师电视剧	不检索
波兰语小说	不检索
小说	不检索
韩国的小说	有哪些好看的韩国小说
写小说的方法	不检索
新手写小说	发表小说的平台有哪些
起点中文网	不检索
生日是什么	不检索
最近的运势	2月21日是什么星座
双鱼星座	双鱼座近日运势
双鱼座表白	双鱼座速配星座
双鱼座最近运势	不检索
扬州景点	瘦西湖
扬州的园林建筑	扬州的景点
瘦西湖	瘦西湖
瘦西湖门票	瘦西湖门票
瘦西湖四桥烟雨	瘦西湖
vr游戏	不检索
vr游戏	vr游戏
超级魔方	不检索
vr和线上游戏的区别	不检索
团建	团建的活动
小狗	不检索
金毛	金毛
养小狗的注意事项	宠物狗
金毛	金毛
金毛和哈士奇的区别	不检索
春天的养生	不检索
春天的养生	春天养生方法
调脾胃的方法	如何调脾胃
冰淇淋的好处	不检索
吃冰淇淋的危害	不检索
为什么便秘	不检索
有助于消化的水果	有助于消化的水果
水果的营养价值	不检索
吃水果的好处	不检索
吃水果的好处	不检索
射雕英雄传	射雕英雄传小说
射雕英雄传	不检索
黄蓉	黄蓉的性格特点
黄蓉的性格	不检索
郭靖	不检索
退休生活	退休生活
退休生活	退休以后做什么
养宠物的好处	退休养宠物
养宠物的好处	退休养花
养花的好处	养花的好处
适合养花的花	适合养的花
历史的影响	不检索
九子夺嫡	九子夺嫡的历史
九子夺嫡电视剧	演过九子夺嫡的电视剧
《步步惊心》	《步步惊心》的介绍
刘诗诗	不检索
玩游戏的危害	不检索
斗地主	斗地主
斗地主	防沉迷
手机防沉迷	不检索
玩游戏的年龄限制	不检索
草莓的营养价值	草莓
草莓价格	草莓价钱
草莓蛋糕	草莓蛋糕
草莓汁	草莓汁
草莓汁多少钱一杯	草莓汁价钱
草莓价钱	不检索
小孩上小学	陕西安康最好的小学
安康第一小学	不检索
小孩接受更好的教育	小学教育注意事项
孩子怕家长	孩子为什么怕家长
陪伴孩子的时间	不检索
喜欢动漫的手办	不检索
海贼王手办	不检索
海贼王作者	海贼王作者
海贼王人物	海贼王人物
路飞手办	不检索
化妆的好处	不检索
眼睛变大的原因	睫毛膏牌子
眉笔推荐	眉笔牌子
伊蒂之屋自然眉笔	不检索
植村秀砍刀眉笔	不检索
爱情电影	不检索
科幻电影	诺兰盗梦空间
彗星来的那一夜	彗星来的那一夜平行世界
芬奇	芬奇影评
国内上映的科幻电影	不检索
星座	不检索
五行	五行
五行出生日期	五行
射手座	射手座
射手座的性格	不检索
钓鱼的好处	不检索
钓鱼的好处	钓鱼分类
溪钓	不检索
公园钓鱼	钓鱼好处
钓鱼的好处	不检索
当航天员的好处	不检索
伟大航天员	伟大航天员有哪些
景海鹏	不检索
中国航天事业的发展	中国航天事业的发展
中国航天事业的发展	不检索
深圳的景点	不检索
摄影的好处	不检索
深圳哪里有氛围的咖啡店	摄影中光线的运用
学习摄影的方法	学习摄影的书
深圳哪里有卖摄影的店	深圳天气
仙人掌的好处	不检索
吊兰	吊兰
容易养的植物	容易养的植物
养仙人掌需要注意什么	养仙人掌的注意事项
养仙人掌的注意事项	不检索
王冰冰	王冰冰
王冰冰	记者类别
当记者的好处	著名战地记者
当记者的成就感	不检索
当记者的理想	不检索
读书无用论	不检索
作家	莫言
莫言	不检索
莫言	莫言作品
莫言	不检索
杨幂	不检索
杨幂的电视剧	杨幂的电视剧
杨幂的电视剧	不检索
杨幂的电视剧	雪见
景天	景天
景天	不检索
减肥的好处	不检索
天气冷的原因	减肥
减肥的方法	不检索
健身房	不检索
早上锻炼的好处	不检索
《我是歌手》	不检索
喜剧片	好看的喜剧片有哪些
《有话好好说》	不检索
日本喜剧片	日本喜剧片
《了不起的亡灵》	《了不起的亡灵》
深圳明日天气	深圳明日天气
深圳明天天气	深圳后天天气
深圳万象城商场	不检索
女生和男生的区别	不检索
深圳万象城商场	深圳万象城餐饮
今天的天气	今天天气状况
今天的天气	不检索
三亚天气	三亚今天的天气状况
三亚天气	不检索
三亚年假	不检索
安阳绿茶	不检索
绿茶养生	不检索
养生的茶	不检索
喝茶的好处	养生汤
熬夜的时候喝什么汤	不检索
养生汤	不检索
李易峰	李易峰
古剑奇谭主题曲李易峰	古剑奇谭主题曲李易峰
古剑奇谭电视剧	不检索
古剑奇谭	不检索
古剑奇谭	不检索
原神	不检索
原神光遇	光遇
原神的玩法	不检索
原神需要多少钱	原神的玩法。
原神游戏	不检索
摄影的好处	不检索
单反的优点	怎么拍出好看的照片
摄影的好处	不检索
单反的像素	摄影需要什么设备
相机的品牌	相机的牌子有哪些
索尼相机	索尼的相机的价位一般在哪里
素炒鸡蛋	不检索
鸡蛋的营养价值	鸡蛋中含有丰富的维生素，可以降低血脂和保护视力。
素炒鸡蛋	鸡蛋吃多
素炒鸡蛋做法	素炒鸡蛋做法
素炒鸡蛋	不检索
素炒鸡蛋	不检索
花籽分好几种	不检索
太阳花	不检索
三色堇和太阳花	太阳花
为什么叫太阳花	为什么叫太阳花
养花的注意事项	养花
太阳花土壤	太阳花土壤
吃什么可以缓解饥饿	热干面
武汉美食	武汉美食
早上吃什么	不检索
吃肉的好处	吃肉有什么好处
身材焦虑	身材焦虑
推荐的网络小说	不检索
无聊小说	凡尔纳
凡尔纳	神秘岛凡尔纳
神秘岛	不检索
凡尔纳	凡尔纳
运动减肥	不检索
减脂餐	零卡调料
好吃的咸味的调料	零卡油醋汁
鸡胸肉西兰花	不检索
鸡肉可以吃吗	不检索
周杰伦	周杰伦
《夜曲》	周杰伦《夜曲》
周杰伦的歌	不检索
周杰伦的台湾	不检索
周杰伦的吐槽	不检索
安抚巾	安抚巾
安抚巾的作用	不检索
安抚巾的作用	不检索
jellycat	jellycat
jellycat	jellycat价格
失恋的原因	不检索
异地恋	不检索
失恋的原因	不检索
失恋电影	电影失恋
失恋的原因	不检索
多肉	不检索
多肉	不检索
多肉能养吗	多肉怎么养
多肉好养吗	不检索
多肉为什么颜色鲜艳	多肉怎么上色
多肉为什么休眠	不检索
高中同学来家里吃饭	不检索
做菜的好处	不检索
硬菜	硬菜
红烧螃蟹	红烧螃蟹
江门螃蟹	不检索
新潮裤子	最近新潮的裤子
适合穿的裤子	不检索
牛仔裤的款式	牛仔裤可以搭配什么
商场	不检索
商场脚疼	不检索
唐山市天气	不检索
吃水果的好处	不检索
榴莲价格	不检索
泰国榴莲	猫山王榴莲
榴莲上火	上火
同人文	同人文
哈利波特同人文	不检索
德赫	德赫
哈利波特同人文	不检索
《像天使一样堕落》	不检索
吃水果的好处	上火可以吃哪些水果
冬天的西瓜	不检索
柚子的好处	柚子产地
沙田柚和溪蜜柚的区别	不检索
柚子的产地	不检索
漳州景点	不检索
漳州景点	漳州有什么景点
漳州繁华的商场	漳州繁华的地带
漳州天气	不检索
漳州历史	不检索
今天天气	今天天气
上海迪士尼乐园天气	不检索
晒黑的危害	防晒小妙招
吃番茄防晒	吃番茄防晒
上海迪士尼乐园	不检索
海蒂的爷爷	海蒂的爷爷
《海蒂的爷爷》	不检索
《海蒂的爷爷》	海蒂的爷爷类似的电影
《菊次郎的夏天》	不检索
《菊花次郎的夏天》	不检索
衣服的款式	衣服的品牌
香奈儿的发展史	香奈儿的发展历史
香奈儿的珠宝系列	香奈儿的发展史
香奈儿的服装有什么特点	香奈儿服装的特点
老佛爷和香奈儿的关系	香奈儿和老佛爷之间的关系
老佛爷对香奈儿的贡献	老佛爷对香奈儿的贡献
减肥的方法	减肥
跳绳的好处	运动减肥
跳绳的好处	跳绳的好处
跳绳推荐	跳绳的工具
适合的鞋子	不检索
跳绳的好处	不检索
林正英	不检索
林正英	不检索
林正英僵尸片	林正英的僵尸片。
林正英的孩子	林正英，生过孩子吗？
林正英	不检索
孙悟空七十二变	孙悟空七十二变
孙悟空听唐僧的	不检索
紧箍咒是谁给悟空戴上的	谁给孙悟空戴上了紧箍咒
孙悟空齐天大圣	不检索
孙悟空被压在五指山	不检索
李佳琦直播间	李佳琦直播间
李佳琦口红	口红品牌
娇兰口红	娇兰宝石口红
娇兰宝石口红	不检索
娇兰宝石口红价格	娇兰宝石口红价格
银行取钱	不检索
银行取钱	附近的银行
银行取钱	银行取钱
银行的大门	不检索
过年的红包	银行的用处
银行理财产品	不检索
美图	不检索
好看的照片	不检索
镜子和拍出来的人的不同	相机拍出来的和镜子中的人不一样
镜子和相机的区别	镜子的自己是真实的长相吗
自拍的技巧	自拍的技巧
拍照的app	不检索
巩俐	巩俐
巩俐	巩俐
巩俐	巩俐
巩俐	不检索
巩俐	巩俐
第一份工作	不检索
咖啡师	咖啡师
咖啡师	咖啡种类
咖啡豆的重要性	咖啡豆
咖啡豆的种类	不检索
吃中药的好处	气血不足吃中药
气血不足中药	气血不足中药
气血不足中药	不检索
气血不足吃什么药	不检索
同仁堂	北有同仁堂
懒的时候怎么运动	不检索
游泳的好处	游泳的好处
游泳注意事项	游泳基础怎么学
蛙泳教练	游泳找教练好处
游泳的好处	不检索
香奈儿老佛爷去世	香奈儿总监
香奈儿经典款	小黑裙赫本
赫本的《蒂凡尼的早餐》	罗马假日
窈淑女	赫本窈淑女
《窈淑女》	不检索
喜欢的作家	喜欢的作家
曹禺的作品	曹禺的作品
曹禺的作品	不检索
悲剧作品	悲剧作品
汉宫秋	不检索
看电脑太多的危害	看电脑太多有什么危害
脖子酸疼	推拿的好处
推拿疼吗	推拿疼么？
推拿疼吗	不检索
推拿时间	不检索
雅思托福	雅思托福
英国读研	英国读研
雅思难吗	雅思考试
雅思托福	雅思补习班
雅思辅导班	不检索
《成瘾剂量》	《成瘾剂量》
《成瘾剂量》	不检索
《成瘾剂量》	《成瘾剂量》的意义
《成瘾剂量》的意义	不检索
《成瘾剂量》的专有名词	假性成瘾
好的医生	不检索
聪明的一休	聪明的一休主题曲
聪明的一休	聪明的一休
聪明的一休	动画片一休
一休	动画片一休
一休	一休
吃零食的危害	不检索
辣条的好处	吃辣条的危害
无辣不欢	不检索
健康的零食	健康的零食
坚果的好处	不检索
坚果的好处	不检索
学舞蹈的好处	舞蹈类型
街舞	街舞
街舞的身体柔软度	不检索
女生太古典舞	不检索
吉布提广场	不检索
街舞的学习方法	不检索
养花的好处	不检索
花名。	不检索
绿萝好养吗	绿萝好养吗
深圳花市	香港哪里卖花
香港七姊妹花店	不检索
含糖最高的水果	含糖最高的水果是
含糖最高的水果	不检索
吃什么水果长胖	健康bmi是多少
bmi	bmi
bmi值	不检索
网球	网球主要技术
网球初学者	网球反手击球要领
网球击球时间	不检索
网球后摆练习	网球水平等级
网球初学者	不检索
附近跑步的地方	附近跑步
明天天气	不检索
健身房	不检索
健身房办卡	健身房办卡
健身房价格	不检索
余华的《许三观卖血记》	余华的作品
活着是讲什么故事的？	余华《活着》
余华的背景	余华介绍
余华的背景	不检索
余华的书	不检索
科比去世	科比去世
科比	科比布莱恩特
科比	科比布莱恩特
科比布莱恩特	科比布莱恩特
科比入选了好几次全明星	科比布莱恩特
电脑好用的软件	不检索
轻薄本	电脑轻薄本
联想笔记本	不检索
mac电脑	mac电脑
二手交易平台	二手交易软件
五险一金	五险一金
五险扣钱	五险
公司不给你办理五险一金	不检索
公司不给你办五险一金	不检索
退休的养老金	不检索
退休的养老金	不检索
小姨多鹤	小姨多鹤
严歌苓	严歌苓
严歌苓	严歌苓
严歌苓	天浴严歌苓
严歌苓	严歌苓
无人生还作者	无人生还作者
阿加莎克里斯蒂	阿加莎克里斯蒂
无人生还简介	无人生还简介
无人生还小说	无人生还小说评价
无人生还销量	无人生还小说销量
无人生还作者	不检索
冬奥会	不检索
花样滑冰	花样滑冰
王诗玥柳鑫宇	王诗玥柳鑫宇
东北的花滑学校	东北天然造冰场
健美操	不检索
澳门交通	澳门交通特色
澳门交通为什么排长龙	澳门交通规划
澳门交通的特点	不检索
红豆饼蛋挞	不检索
澳门的酒店	不检索
看电影的好处	不检索
黑客帝国	黑客帝国
黑客帝国新电影	黑客帝国新电影
沃卓斯基电影	沃卓斯基电影好看
v字仇杀队	沃卓斯基v字仇杀队
鬼灭之刃	鬼灭之刃
鬼灭之刃在哪里	鬼灭之刃
b站的会员可以看鬼灭之刃吗	不检索
鬼灭之刃故事梗概	鬼灭之刃讲了什么
鬼灭之刃	不检索
赵露思	赵露思
赵露思	赵露思长相
赵露思胖吗	赵露思胖吗
赵露思上镜胖十斤	不检索
赵露思的长相	不检索
鬼灭之刃无限列车剧场版	鬼灭之刃无限列车篇
炼狱杏寿郎牺牲	炼狱杏寿郎牺牲的价值
鬼灭之刃游郭篇	不检索
鬼灭之刃游郭篇	鬼灭之刃游郭篇
音柱的三大老婆	不检索
百合花	不检索
养花的经验	不检索
醒花	醒花注意事项
养花多久	不检索
百合花香气	百合花香气
养花的好处	不检索
冬天的草莓	什么时候有草莓
冬天的草莓是反季节水果吗？	冬天的草莓是反季节水果
草莓蛋糕	草莓味的美食
冬季草莓价格	冬季草莓价格
99号草莓	不检索
减肥的危害	不检索
吃夜宵的危害	宅家运动
瑜伽	瑜伽
瑜伽的好处	不检索
太极拳	太极拳
减肥的运动	运动减肥
跳绳注意事项	跳绳注意
跳绳和其他运动一起做是不是会更好	有氧运动无氧运动
无氧运动	无氧运动
无氧运动	不检索
早上吃什么	不检索
早上做什么饭	不检索
怎么做好吃的饭	不检索
烹饪视频	不检索
学做饭的方法	不检索
包包	不检索
奢侈品包	奢侈品包
lv包	不检索
香奈儿马鞍包	香奈儿马鞍包
香奈儿马鞍包价格	不检索
流浪地球电影	流浪地球电影
流浪地球电影	流浪地球电影演员
流浪地球剧情	电影流浪地球
流浪地球	流浪地球剧情
流浪地球电影	流浪地球票房
流浪地球电影	不检索
元宇宙	元宇宙
元宇宙公司	facebook公司改名
元宇宙的前景	元宇宙的前景
元宇宙的前景	不检索
元宇宙的股票	不检索
最近的电影	2021年热门电影
2021年电影	不检索
你好李焕英	你好李焕英剧情
你好李焕英	你好李焕英
你好李焕英	贾玲妈妈
吃寿司的好处	不检索
学习做菜的方法	不检索
怎么做寿司	怎么做寿司
吃牛油果的好处	不检索
寿司是哪个国家的食物	寿司是哪个国家的食物
寿司是哪个国家的食物	不检索
湖北省荆州市天气	湖北省荆州市天气
荆州景点	不检索
荆州景点	湖北省荆州市景点
荆州古城景区	荆州古城景区
荆州景点	不检索
手脚冰凉	手脚冰凉
贫血的危害	贫血药食补
吃肉的好处	不检索
毛肚泡脚	不检索
针灸的好处	不检索
民生银行	民生银行和其他银行的区别
小微企业的金融服务	不检索
经济学专业适合学什么	经济学专业和计算数学专业的不同
经济学和数学的区别	不检索
银行工作	不检索
日语学习	学习日语基础
日语学习方法	动漫学日语
进击的巨人	进击的巨人介绍
进击的巨人主角	进击的巨人介绍
进击的巨人	进击的巨人的内容
《我们仨》	《我们仨》是谁写的
杨绛	钱钟书
杨绛和钱钟书的爱情	杨绛和钱钟书的爱情
王小波的作品	王小波的作品
王小波的作品	不检索
体测跳远	体测跳远
体测跳远练习	体测跳远练习
跳远练习	体测跳远练习
跳远诀窍	跳远诀窍
原地模仿起跳练习	原地模仿起跳练习
原地模仿起跳练习	不检索
muka	不检索
法国歌手	不检索
法国歌手	法国歌手有哪些
乔伊丝乔纳森	乔伊丝乔纳森
乔伊丝乔纳森	不检索
江西省吉安市	不检索
江西吉安房价	不检索
江西吉安天气	不检索
2021年的房地产发展方向	不检索
2021年	不检索
旅行的好处	不检索
日本旅行	不检索
东京塔	东京塔
寿司	不检索
寿司	不检索
吃腻的食物	不检索
德州市美食	附近美食
韩式烤肉	附近商场
山东德州美食	最近天气
德州市天气	不检索
晚上的娱乐	不检索
最近的电影	穿过寒冬拥抱你
《穿过寒冬拥抱你》	爱情神话电影
《爱情神话》	不检索
经典喜剧	经典喜剧
车厘子贵吗	车厘子为什么贵
车厘子和樱桃是一个品种吗	车厘子和樱桃是一个品种吗
车厘子和樱桃是一个品种吗	车厘子和樱桃是一个品种吗
车厘子和樱桃的区别	不检索
吃车厘子的好处	吃车厘子的好处
吃车厘子的好处	不检索
六级考试	不检索
拖延症	拖延症的表现
六级分数怎么通过	六级多少分通过
英语考试	不检索
六级考试时间	不检索
旅行的好处	不检索
旅行的经验	不检索
洛阳	洛阳景点
旅游需要准备什么	旅游需要准备什么
旅游注意事项	不检索
穿搭的风格	不检索
学习穿搭的网站	学习穿搭的网站有哪些
学习穿搭的网站	网上哪里可以买到便宜又高质量的衣服
时尚穿搭	不检索
风衣多少钱	不检索
养百合的好处	养百合的好处
养花的好处	不检索
什么花比较好养	好养活的花
仙人球	好养活的花
吊兰	不检索
韩国演员	韩国演员
朴信惠	继承者们演员
朴信惠	朴信惠
匹诺曹	电视剧《匹诺曹》
朴信惠	不检索
三亚	三亚的风景
三亚景点	小红书
小红书	不检索
散步的好处	不检索
椰子鸡餐馆	不检索
穿搭	不检索
穿搭的风格	不检索
穿搭博主	小红书穿搭博主
晚晚穿搭	不检索
酷酷的衣服	不检索
听音乐的好处	不检索
古典音乐	不检索
《匈牙利狂想》	《匈牙利狂想》
弗朗茨李斯特	弗朗茨李斯特
弗朗茨李斯特	不检索
黄石天气	黄石天气
言情小说	不检索
倾城王爷要休妃	墨舞碧歌
墨舞碧歌	墨舞碧歌其他小说
黄石天气	不检索
天蝎座	天蝎座人性格
天蝎座朋友	天蝎座朋友
天蝎座的性格	不检索
白羊座和天蝎座配吗	白羊座天蝎座
白羊座和天蝎座的爱情	不检索
旅行的好处	不检索
香港景点	中国旅游胜地
爬山	泰山
泰山在哪里	泰山
泰山	不检索
保定天气	不检索
雪人	不检索
滑雪	滑雪
滑雪注意事项	不检索
看电视的好处	《成瘾剂量》
悬疑电影	《成瘾剂量》
红楼梦电视剧	红楼梦电视剧
名著电视剧	西游记电视剧
西游记翻拍	不检索
红楼梦电视剧	不检索
红楼梦的情节	不检索
电影《我是歌手》	不检索
经典电影	经典电影
这个杀手不太冷	不检索
好吃的辣条	附近的辣条
鸡排	麻辣王子
麻辣王子	附近的超市
长沙今天天气	长沙天气
长沙天气	不检索
胡歌	胡歌电视剧
胡歌	胡歌电视剧
胡歌	不检索
长征是什么时候的事	长征
长征的意义	长征的原因
长征	长征
长征终点	长征终点
长征精神	长征精神
就业	不检索
北京就业	不检索
异地恋	异地恋
异地恋难吗	文科生如何在北京就业
如何开始实习	不检索
东汉末年分三国	林俊杰曹操
林俊杰的曹操	林俊杰
林俊杰的歌	林俊杰的新歌
林俊杰和田馥甄	林俊杰和田馥甄在一起了么
林俊杰和田馥甄	不检索
发大财的方法	发大财
买彩票能中奖吗	不检索
哪里可以买到彩票	买彩票的地方
路边彩票	不检索
刮刮乐	不检索
手机被偷了怎么办	不检索
王者荣耀	王者荣耀
貂蝉	王者荣耀貂蝉
王者荣耀貂蝉	不检索
王者荣耀貂蝉	不检索
王者荣耀貂蝉	不检索
吉林市旅游	不检索
长白山适合什么时候去	长白山天池适合什么时候去
喀纳斯和长白山	长白山天池和喀纳斯
喀纳斯景点	喀纳斯景点
从吉林到喀纳斯的火车	去喀纳斯怎么走
吉林到喀纳斯飞机	不检索
宝宝1岁	不检索
宝宝睡觉的危害	哄小孩睡觉的方法
宝宝不睡觉的原因	不检索
宝宝说话	如何教宝宝说话
宝宝听音乐的好处	不检索
身体不舒服的原因	不检索
运动的好处	促进身体健康的运动
平板支撑	平板支撑的技巧
身体不舒服的原因	不检索
球类运动	不检索
景天徐长卿龙葵飞蓬花楹重楼	不检索
景天中药	景天中药
景天作用	景天作用
景天用法	景天中药用法
景天用法	景天用法注意
景天的作用	不检索
朝朝宝	朝朝宝
朝朝宝利率	朝朝宝利率
朝朝宝的利率	不检索
朝朝宝的年利率是多少？	不检索
朝朝宝的优势	不检索
运动的好处	不检索
济源市的景点	不检索
济源市体育馆	济源市的篮球场
济源市篮球场	篮球运动怎么学习
济源市篮球场	不检索
高血糖的危害	高血糖
高血糖的危害	高血糖诱因
冠心病	冠心病高血糖
高血糖如何医治	高血糖如何医治
高血糖运动	高血糖治疗运动
高血糖如何医治	不检索
星座	不检索
6月份出生的星座	十二星座
双子座的特点	双子座
双子座的性格	双子座特点
双子座和什么星座最配	双子座最配的星座
风象星座	风象星座
西餐	西餐
寿司	寿司
环游世界的美食	不检索
法国美食	法国美食
棍式面包	棍式面包
法国美食	不检索
《香蜜沉沉烬如霜》	《香蜜沉沉烬如霜》主演
邓伦	邓伦作品
邓伦的作品	不检索
邓伦的眼睛	不检索
邓伦	不检索
小众旅行	不检索
小众旅行	小众旅行地点
河南郭亮村	河南郭亮村
郭亮村	不检索
云南美食	不检索
美妆品牌。	美妆的品牌
雅诗兰黛	雅诗兰黛
雅诗兰黛贵吗？	雅诗兰黛贵吗
雅诗兰黛最好的产品	雅诗兰黛最好的产品是什么
雅诗兰黛的唇膏	什么牌子的唇膏最好
dhc是日本的牌子吗？	dhc
注册会计师考试	注册会计师考试如何准备
注册会计师考试的辅导机构	注册会计师的优秀辅导机构
注册会计师报名时间	2022年注册会计师报名时间
注册会计师考试科目	注册会计师考试科目
注册会计师综合阶段考试的通过率	注册会计师综合阶段考试的通过率
榴莲的好处	为什么喜欢吃榴莲
榴莲的味道	不检索
榴莲的味道	不检索
水蜜桃	吃水蜜桃的好处
水蜜桃的营养价值	不检索
吃水蜜桃的好处	不检索
凉皮美食	汉中美食
汉中凉皮店	凉皮汉中店推荐
凉皮配什么吃	不检索
汉中凉皮店	不检索
汉中凉皮店	不检索
春夏穿搭	今天的天气
裸奔	不检索
好看又价格合适的衣服	不检索
网店和实体店的区别	网店比实体店的衣服便宜
网购的坏处	不检索
西游记抖音	不检索
金钱豹	不检索
金钱豹	唐僧和女儿国
《西游记》中的美女	不检索
《西游记》中的人物	《西游记》的意义
唐僧的性格	不检索
北京周末有球赛吗	不检索
打篮球的好处	不检索
姚明	不检索
姚明退役	不检索
姚明退役后做什么	不检索
画糖饼	不检索
画糖饼	《鱿鱼游戏》
画糖饼	不检索
画糖饼	不检索
画糖饼	不检索
做老师的资质要求	做老师的资质要求
教师资格考试的内容	教师资格考试介绍
学而思老师	不检索
天津的高中	天津市的高中有哪些
教师资格考试	不检索
听音乐的好处	死亡金属音乐
死亡金属音乐	喜欢听重金属是什么感觉
死亡金属音乐	不检索
爱的死亡	不检索
网易云音乐	不检索
乒乓球直拍还是横拍？	乒乓球横拍和直拍的区别
横拍的特点	不检索
乒乓球牌子	乒乓球品牌推荐
乒乓球课程系统	不检索
乒乓球老师	不检索
早上起不来床	不检索
老师开摄像头	不检索
化妆的步骤	不检索
口红推荐	口红色号
小白适合的口红	不检索
百香果	不检索
百香果怎么吃	百香果吃法
百香果怎么吃	不检索
百香果饮料	百香果饮料品牌
辽宁省大连市的超市	不检索
宠物狗的品种。	阿拉斯加狗
小型犬	小型犬都有什么品种
泰迪	不检索
狗狗的价格	澳门特别行政区花王堂区宠物店
花王堂区新胜街犬舍	不检索
杨幂眼睛	不检索
杨幂	杨幂
杨幂演的电视剧	杨幂演的剧
夕瑶	不检索
夕瑶	夕瑶
周日节目	周日综艺节目
湖南卫视周日节目	湖南卫视周日节目
天天向上节目	天天向上节目
天天向上节目	天天向上节目
天天向上嘉宾	天天向上节目
退休生活	不检索
养生的好处	养生
瑜伽	瑜伽
瑜伽的好处	不检索
太极	太极
太极	不检索
羊驼	羊驼的叫声
羊驼叫声	羊驼
羊驼生活习性	羊驼生活习性
羊驼胆小	羊驼胆小
养羊驼的步骤	不检索
羊驼	不检索
零食推荐	零食品牌推荐
辣口味的零食	零食品牌推荐
yyds	不检索
甜的零食	甜点零食推荐
饮料	饮料推荐
川菜	川菜有哪些
麻婆豆腐做法	麻婆豆腐做法
黄酒	黄酒
黄酒味道	黄酒味道
黄酒味道	不检索
吕梁交通	不检索
高铁和飞机的区别	不检索
北京到成都的交通	北京到成都飞机和高铁用时
疫情	西安疫情
西安疫情	不检索
假新闻的危害	虚假新闻是最易被识破的
疫情新闻	假新闻疫情
双黄连事件	“双黄连可以抑制新冠状病毒”
新冠状病毒疫情	疫情新闻悬在心上
疫情什么时候能够结束	疫情什么时候能够结束
疫情什么时候能够结束	不检索
旅游的好处	不检索
新疆旅游	不检索
疫情	疫情旅游行业影响
新疆旅游	新疆旅行冬季
新疆旅游	不检索
多肉的品种	不检索
紫色莲花多肉	紫色莲花多肉
紫色莲花多肉	紫色莲花多肉
好养的多肉	好养的多肉
观音莲多少钱	观音莲多少钱
吉隆坡交通	吉隆坡交通
吉隆坡交通	吉隆坡地势
吉隆坡交通	不检索
找工作的注意事项	不检索
学语文的老师	不检索
听民谣的好处	不检索
房东的猫	房东的猫
房东的猫今年的作品	房东的猫作品
房东的猫歌曲	不检索
多想在平庸的世界拥抱你	不检索
发际线后退	压力发际线后退
熬夜的危害	中药防脱发
含中药洗发水的洗发水	不检索
中药生发	不检索
熬夜的危害	不检索
老师	不检索
警察工作	警察工作内容
警察的职业	不检索
当警察很危险吗	警察工作
警察假期	不检索
脸出油的原因	不检索
油皮怎么脱妆	油皮粉底液
雅诗兰黛dw粉底液评价	不检索
雅诗兰黛dw粉底液色号	雅诗兰黛dw粉底液色号
为什么油皮用了油底液就长痘了	不检索
张艺兴	不检索
张艺兴的代表曲目	张艺兴的代表曲目
张艺兴和孙红雷演的电视剧	张艺兴和孙红雷演的电视剧
扫黑风暴张艺兴	不检索
张艺兴的电视剧	不检索
水果软糖	不检索
dobby软糖	dobby软糖
dobby软糖	dobby软糖
dobby软糖	dobby软糖
dobby软糖价格	dobby软糖
买房注意事项	买房关注点
北京未来发展的区域	北京将发展的区域
东坝房价	北京东坝优点
恒大地产的房子买了就烂尾了	不检索
环京房价	2022年环京房价下跌
刘涛	刘涛电视剧
芈月传刘涛	刘涛芈月传
刘涛的演技	刘涛演员
刘涛离婚	演员刘涛丈夫
刘涛演的电视剧	刘涛演戏丈夫
刘涛演的电视剧	不检索
设计师是什么职业	设计师
服装设计师	不检索
室内设计师	如何成为室内设计师
室内设计师的图书馆	不检索
北京的室内设计师工作	室内设计师在北京容易找到工作嘛
洗脸产品	男士洗脸用什么牌子比较好？
碧欧泉男士洗面奶	不检索
洁面乳和洗面奶的区别	洁面乳和洗面奶的区别
洁面乳和洗面奶的区别	高夫男士洁面乳评价
高夫经典保湿磨砂洁面乳	不检索
山西运城天气	不检索
宅家的生活	不检索
天蚕土豆	天蚕土豆
天蚕土豆	天蚕土豆所有小说
《斗破苍穹》	不检索
现在的追星现象	如何看待现在的追星现象
国家号召关注科学家	国家号召关注科学家
国家的科研工作者的薪资	不检索
正确追星	怎么正确追星
如何正确追星	不检索
吃遍天下美食的好处	不检索
马奶酒	内蒙古美食
马奶酒	马奶酒
马奶酒	不检索
锡林郭勒景区	不检索
菜园子	不检索
菜园子的好处	菜园子里可以种什么菜
白菜萝卜	不检索
冬季菜园子怎么办	冬季菜园子种什么菜
冬天可以种的菜	不检索
春晚	不检索
演员能歌善舞吗	不检索
初学跳舞的方法	不检索
爵士舞	爵士舞
爵士舞哪里学	不检索
上海钓鱼	不检索
质量好的鱼竿	质量好的鱼竿品牌质量好的鱼竿品牌
光威鱼竿	不检索
上海哪里卖鱼具	上海是卖鱼具的地方
上海城隍庙附近的福佑路小商品市场	不检索
最近好看的动漫	不检索
名侦探柯南	名侦探柯南
名侦探柯南	名侦探柯南
名侦探柯南	名侦探柯南其他角色
名侦探柯南集数	名侦探柯南集数
张爱玲	我国的才女
张爱玲的作品	张爱玲的作品
倾城之恋	《倾城之恋》
张爱玲的作品	张爱玲的倾城之恋的影响
张爱玲的作品	不检索
张爱玲的才气	张爱玲的才气从哪里来的
许嵩新歌	不检索
网易云可以下载许嵩的歌	不检索
许嵩断桥残雪	许嵩断桥残雪
许嵩演唱会	许嵩演唱会
许嵩2021年btv全球跨年冰雪盛典	不检索
运动的好处	不检索
打球的种类	不检索
打羽毛球减肥	不检索
羽毛球和篮球哪个更容易上手	不检索
羽毛球拍	不检索
酸汤鱼	酸汤鱼特色
酸汤	酸汤贵州
酸汤鱼	不检索
酸菜汤	不检索
红烧肉	不检索
辽宁盘锦	不检索
盘锦景点	盘锦的景点
盘锦景点	盘锦的美食
盘锦天气	不检索
盘锦景点	不检索
柯南	名侦探柯南
日本动漫	宫崎骏动漫
宫崎骏的音乐	不检索
好吃的美食	附近的美食
长沙美食	不检索
林芝美食	不检索
陕西美食	不检索
粉	粉推荐
广西螺蛳粉	不检索
好吃的螺蛳粉牌子	螺蛳粉牌子推荐
《七月与安生》	《七月与安生》
《七月与安生》结局	《七月与安生》结局的深意
周冬雨	不检索
易烊千玺和冬雨合作	不检索
易烊千玺	不检索
2022年上映的电影	2022年春节上映的电影有哪些
《这个杀手不太冷静》	《这个杀手不太冷静》
《狙击手》	不检索
喜羊羊	不检索
喜羊羊	不检索
吃零食的危害	抗糖
吃零食的危害	不检索
宣城甜品店	宣城甜品店
芒芝恋港式甜品	芒芝恋港式甜品推荐
芒芝恋港式甜品	不检索
参加音乐会的人数	不检索
钢琴曲选什么	钢琴曲推荐
钢琴曲	不检索
经常弹钢琴的好处	简单钢琴曲
菊次郎的夏天钢琴曲	不检索
买房的好处	不检索
资阳市房价	资阳市区
买房的事情	买房的程序
买房注意事项	不检索
结婚买房	不检索
婚前财产	婚前财产
绿萝	不检索
绿萝叶子变黄	绿萝叶子变黄
绿萝叶子发黄	绿萝浇水
绿萝叶子变黄	不检索
绿萝浇水	不检索
老年人常见病	长辈常见病
高血压的危害	高血压
牙齿问题	不检索
牙齿软做烂	不检索
种植牙	不检索
冬残奥会时间	冬残奥会
学滑雪的好处	不检索
哈尔滨学滑雪	不检索
学滑雪的好处	不检索
哈尔滨滑雪	不检索
冬枣价格	不检索
冬枣	不检索
冬枣病毒	不检索
红心柚	红心柚
吃柚子的注意事项	柚子营养
高血压患者吃柚子	不检索
生发液	中药成分生发液推荐
掉发的原因	掉发严重
熬夜的危害	熬夜的坏处
晚上玩手机的危害	晚上想玩手机怎么办
晚上玩手机的危害	不检索
冬奥会	羽生结弦
羽生结弦	羽生结弦有多美
央视夸赞羽生结弦	央视夸赞羽生结弦
羽生结玄	羽生结玄出生年份
羽生结玄	不检索
理发师	理发师的工资
理发师的工资	不检索
理发师的缺点	不检索
理发师的学校	理发师的学校
理发师的职业	不检索
花店	不检索
天蝎座性格	天蝎座性格
天蝎座性格	不检索
天蝎座怎么定	天蝎座
天蝎座的人比较腹黑吗	不检索
白羊座	白羊座观测
长日将尽	长日将尽小说
石黑一雄	石黑一雄
长日将尽翻译	长日将尽谁翻译的
冒国安	冒国安作品
冒国安	石黑一雄小说
买房的好处	不检索
买房的好处	楚雄房价
楚雄房价	楚雄买房哪里地段好
楚雄东南新区	楚雄东南新区楼盘优势
楚雄东南新区房价	不检索
作家	不检索
村上春树的代表作	村上春树的代表作
刺杀骑士团长的故事情节	刺杀骑士团长的故事情节
挪威的森林	不检索
挪威的森林	不检索
吃糖果的危害	不检索
吃甜食长胖的原因	吃甜食容易长胖的原因
无痛苦减肥的方法	无痛苦减肥的方法
吃饭快的危害	细嚼慢咽的好处
肚子胀的原因	不检索
双十一双十一	双十一
双十一买什么	不检索
日常生活用品	日常用品
双十一优惠	双十一优惠
日常用品	不检索
国王排名	国王排名动漫
国王排名	国王排名片头曲
日本动漫	不检索
高达的风格	不检索
国内动漫发展	国内动漫
黑龙江省美食	黑龙江有哪些美食
吃菌类的食物	吃菌类的食物有什么好处
吃菌类的好处	不检索
菌类食物怎么做	不检索
吃菌类的好处	不检索
王者荣耀	不检索
王者荣耀	王者荣耀怎么玩
王者荣耀的装备	英雄联盟介绍
王者荣耀专业比赛	王者荣耀赛事介绍
王者荣耀队伍	王者荣耀队伍
喜欢诗歌的原因	不检索
李白的诗	李白想象
宋诗	宋诗
苏轼	苏轼的诗歌
水调歌头	水调歌头歌曲
稻香歌词	不检索
周杰伦的歌曲	周杰伦歌曲网易可以下载吗
qq音乐	不检索
网易云音乐	五月天的歌哪里可以听
林俊杰	林俊杰代表作
觉醒年代	觉醒年代
鲁迅的作品	鲁迅北大
新文化运动	新文化运动
鲁迅	鲁迅的由来
狂人日记	狂人日记
鲁迅的作品	鲁迅的作品
谷爱凌	谷爱玲夺冠
谷爱凌天才少女	谷爱凌天才少女
谷爱凌是中英混血吗	谷爱凌
谷爱凌	不检索
谷爱凌模特	不检索
鸟的好处	不检索
怎么养鸟	什么鸟
养鸟的注意事项	养鸟
鹦鹉学说话	鹦鹉好养吗
虎皮鹦鹉	不检索
科孚	科孚
科孚岛	不检索
科孚岛	科孚城
科孚岛的气候	科孚岛的气温
科孚岛	不检索
科孚海边散步	不检索
春节上映的电影	长津湖电影
长津湖电影	不检索
水门桥主演	水门桥
吴京的电影	不检索
易烊千玺	不检索
延安历史	延安历史事件
延安在长征时期发生了什么	延安在长征时期事件
红军长征为什么选择延安	红军长征在延安
延安土壤	不检索
延安的历史	不检索
国庆假期	国庆假日应该做什么
国庆档电影	2021年国庆档电影
2021国庆档电影《我和我的父辈》	不检索
2021国庆档电影	《我和我的父辈》怎么样
徐峥	徐峥的电影
赵丽颖	不检索
知否知否	知否知否小说
赵丽颖ip小说	不检索
赵丽颖小说	黑河市天气
赵丽颖	不检索
成都火锅	扬州口味
川菜为什么放辣椒	成都吃辣的原因
吃辣的好处	缓解辣
扬州酸奶	扬州天气
扬州天气	不检索
王者荣耀上分	不检索
王者荣耀皮肤	王者荣耀春节皮肤
王者荣耀的英雄	王者荣耀庄周
王者荣耀皮肤	和平精英雨林地图
玩游戏久了头痛	玩游戏会头痛
完美伴侣	完美伴侣电视剧
高圆圆	高圆圆演的电视剧
高圆圆老公	高圆圆的老公
高圆圆和赵又廷合作的电视剧	高圆圆和赵又廷合作的电视剧
高圆圆和陈凯歌合作的电影	不检索
颐和园有多少年的历史？	颐和园有多少年的历史？
圆明园有多久的历史？	圆明园有多久的历史了
颐和园和圆明园的历史	不检索
颐和园和圆明园的区别	颐和园是清朝用来做什么的
颐和园和怡和园的区别	不检索
周冬雨	《山楂树之恋》
周冬雨	周冬雨
周冬雨	彭昱畅作品
向往的生活彭昱畅	向往的生活彭昱畅
彭昱畅的作品	不检索
柯尔鸭	柯尔鸭
柯尔鸭贵	柯尔鸭贵
柯尔鸭吃什么	不检索
柯尔鸭	不检索
柯尔鸭	不检索
谷爱凌	谷爱凌
谷爱凌	滑雪比赛有哪些
滑雪的好处	不检索
羽生结弦	羽生结弦
羽生结弦	不检索
大雪	描述大雪的句子
谢道	白雪谢道
南方人对大雪的执念	南方人对雪的执念
南方人对雪的执着	南方人对雪的执着
南方人对雪的执着	皑皑白雪
冬天的天气	不检索
庆元旦跳的舞。	不检索
芭蕾舞	学芭蕾舞的身体条件
芭蕾舞腿粗	芭蕾舞腿粗
芭蕾舞脚型	不检索
芭蕾舞脚型	不检索
番茄炒蛋	番茄炒蛋
番茄炒蛋	不检索
皮蛋豆腐鸡蛋	不检索
皮蛋豆腐	皮蛋豆腐
皮蛋豆腐	不检索
做饭的好处	不检索
煲汤的好处	煲汤
淮山党参鹌鹑汤	淮山党参鹌鹑汤
淮山党参鹌鹑汤加多少水	淮山党参鹌鹑汤加多少水
淮山党参鹌鹑汤加多少水	不检索
就业英语	就业英语
就业的竞争	就业渠道
找工作的压力	如何缓解压力
如何自我调节	调节心态的方法
如何调节自己的自信心	不检索
感冒的原因	不检索
感冒吃什么药	不检索
感冒吃什么药	不检索
苦的药	不检索
吃中药的好处	不检索
打麻将的好处	不检索
王者荣耀	不检索
曹操	王者荣耀曹操
王者荣耀曹操	不检索
手机恢复出厂设置	手机恢复出厂设置
花甲粉	不检索
花甲贵	花甲价格
花甲粉做法	锡纸花甲粉
花甲粉做法	处理花甲
花甲粉	不检索
莫言诺贝尔	莫言
莫言的《蛙》	莫言《蛙》
莫言的作品	莫言的作品
莫言的作品为什么这么吸引人	莫言作品的影响力
莫言的作品	莫言译本
莫言的作品	不检索
你好，李焕英	《你好，李焕英》
你好，李焕英	《你好，李焕英》
《你好，李焕英》	河南安阳天气预报
电影《你好，李焕英》	《你好，李焕英》电影
电影《你好，李焕英》	不检索
冬奥会	不检索
中国运动员	2022冬奥会金牌
谷爱凌	不检索
谷爱凌	谷爱凌
谷爱凌大学	不检索
邓紫棋	邓紫棋
邓紫棋出道	邓紫棋出道
邓紫棋的歌	不检索
邓紫棋的歌	不检索
邓紫棋新歌	邓紫棋新歌
白糖糕	白糖糕味道
白糖糕多少钱	白糖糕价钱
白糖糕做法	白糖糕做法
白糖糕蒸多久	白糖糕蒸多久
白糖糕白糖和粘米粉比例	白糖糕白糖和粘米粉比例
白糖糕做法	不检索
《斑马》	民谣歌手
宋冬野	赵雷代表作
赵雷	不检索
宋冬野的歌	宋冬野吸毒
宋冬野	宋冬野代表作
吃零食的危害	零食缓解压力
果冻的好处	果冻类型
果冻网站	不检索
网上卖果冻的网站。	不检索
附近的超市	不检索
高考注意事项	不检索
高考压力	不检索
北京大学	北京大学
北大的录取分数线	北京大学分数线广西
北京大学分数线	不检索
小侄女开家长会	不检索
芭蕾舞	不检索
芭蕾舞的毅力	学芭蕾舞需要毅力吗
学舞蹈的孩子	不检索
邱思婷	邱思婷
北京房价	不检索
北京房价	北京市区房价
庆阳市房价	北京朝阳房价
地下室房价	不检索
信用卡	贷款要信用卡吗
年货节的零食	年货节
年货	年货
过年零食	过年零食
零食种类	零食
核桃的营养价值	核桃的营养价值
核桃的营养价值	核桃补脑
广东省茂名市景点	景点
拍照的好处	北京
长城	长城
泰山	不检索
泰山天气	不检索
泰山	不检索
香椿	香椿头
香椿炒蛋	香椿炒蛋
香椿的营养价值	不检索
香椿解冻	不检索
香椿保鲜	不检索
最近的星座运势	不检索
处女座	处女座今天运势
最近的星座运势	不检索
徐州购物中心	徐州苏宁广场的美食店
徐州苏宁广场店	不检索
吴京的影视作品	不检索
武打片	不检索
吴京的电影	吴京电影
流浪地球	流浪地球
刘慈欣	不检索
电视剧	不检索
《人世间》	《人世间》
《人世间》的作家	《人世间》
梁晓声	梁晓声
梁晓声	不检索
北京语言大学	不检索
鹰潭	鹰潭
邯郸	邯郸
邯郸到鹰潭距离	邯郸到鹰潭距离
鹰潭景点	不检索
鹰潭景点	鹰潭景点
米津玄师	米津玄师有哪些歌曲
米津玄师	不检索
宫野真守	不检索
宫野真守	不检索
欧美的歌曲	欧美歌手
林夕	不检索
李荣浩	李荣浩
李荣浩	李荣浩歌曲
李荣浩	不检索
李荣浩演唱会门票	不检索
作家	村上春树
村上春树的文字	村上春树的作品
《挪威的森林》	不检索
东野圭吾	不检索
解忧杂货店翻拍	不检索
薯条	薯条品牌推荐
虾条品牌	虾条品牌
吃薯条停不下来	油炸食品危害
油炸食品	油炸食品的危害
油炸食品吃多了会上火吗	不检索
泰安市美食	驴肉火烧是什么
驴肉火烧	不检索
河北的美食	河北的美食有哪些
山东的美食	山东的美食有哪些
山东的美食	不检索
薯条为什么硬	炸薯条太硬
土豆怎么焯水	不检索
土豆软掉	不检索
薯条为什么炸不酥脆	不检索
薯条怎么炸	不检索
星座	不检索
处女座的特点	处女座特点
金牛座	处女座和金牛座
处女座的优点	不检索
处女座性格	星座该不该信
悲惨世界	悲惨世界音乐剧
悲惨世界的故事情节	悲惨世界情节
巴黎圣母院	巴黎圣母院
巴黎圣母院	不检索
悲惨世界电影	不检索
德州市天气	不检索
托福考试时间	托福
托福词汇	托福考试的难度特点
托福刷题	不检索
托福报名费	托福报名费是多少
姚明	不检索
打篮球的好处	不检索
第一个进入nba的中国人	nba第一个中国人
姚明	姚明入选名人堂
篮球运动	不检索
沈以诚	沈以诚
沈以诚的歌	沈以诚
网易云音乐椿	听歌软件
网易云音乐	不检索
网易云音乐	不检索
汉中商场	不检索
新奇的东西	不检索
酷乐潮玩	酷乐潮玩
酷乐潮玩	不检索
名创优品	名创优品
名创优品	不检索
互联网的好处	不检索
互联网上可以玩的东西	上网可以玩什么
玩游戏的好处	不检索
互联网行业	互联网行业的职业
设计专业的就业方向	不检索
武则天	武则天是谁
武则天	朱元璋
朱元璋参加过农民起义	不检索
中国上下五千年	不检索
养狗的好处	适合养的动物
养宠物的注意事项	兔子好养吗
兔子的优点	宠物
养狗的好处	猫狗的差异
热情的动物	养狗注意事项
养狗的品种	泰迪
减肥的零食	不检索
好吃的零食	不检索
低脂零食	不检索
水果干怎么自制	自制水果干
自制香蕉干	不检索
橙子的好处	橙子的好处
橙子的好处	不检索
橙子的加工方法	橙子用处
橙子的好处	不检索
橙子的营养价值	不检索
雨伞的种类	不检索
雨伞品牌	雨伞选择
网上买雨伞的网站。	雨伞品牌
天堂牌雨伞	天堂牌雨伞
天堂牌雨伞	不检索
旅行的好处	不检索
附近的旅游景点	附近的旅游景点
南山生态	不检索
南山生态园里可以烧烤吗	南山生态园里可以烧烤吗
人生一串	人生一串
美国作家	美国小说作家
拉尔夫爱默生	不检索
拉尔夫爱默生	不检索
漫画作品	美国漫画作家
艾斯纳	不检索
瓜瓜	不检索
怎么挑西瓜	什么样的西瓜甜
西瓜的营养价值	不检索
在哪里买水果比较便宜	在哪里买水果更便宜
北京哪里卖水果最便宜	不检索
糖尿病的危害	糖尿病危害
糖尿病根治	糖尿病根治
糖尿病患者	预防糖尿病
糖尿病患者不能吃的食物	糖尿病患者不能吃的食物
清淡的食物	糖尿病患者食谱
河南省平顶山市天气	河南省平顶山市天气
平顶山天气	平顶山市公园
滑旱冰	滑旱冰
滑旱冰的技巧	不检索
阴计多端	不检索
毛姆	英国作家毛姆
《月亮与六便士》	《月亮与六便士》的意义
《刀锋》的意义	《刀锋》和《月亮与六便士》的相同点
《面纱》	《面纱》的简介
《面纱》	不检索
英国作家毛姆	英国作家毛姆
鞍山景点	不检索
鞍山景点	辽宁鞍山的景点
千山景点	不检索
鞍山天气	辽宁鞍山千山天气
千山天气	不检索
阿黛尔	阿黛尔的作品
阿黛尔的嗓音	阿黛尔的音色
欧美的歌曲	泰勒斯威夫特作品
泰勒的歌	泰勒作品
泰勒的歌	不检索
兔子的好处	兔子当宠物的好处
兔子的品种	兔子的品种
猫猫兔	猫猫兔
养兔子的注意事项	如何养兔子
兔子吃便便	兔子会吃便便吗
第一炉香	第一炉香
张爱玲的风格	张爱玲风格
张爱玲的风格	张爱玲
张爱玲的小说	张爱玲评价
张爱玲的作品	张爱玲作品
考试前准备	考试
考试的好处	考试食物
香蕉、牛奶和巧克力	不检索
考试手表	考试手表
机械表	不检索
琼中明天天气	琼中明天天气
琼中天气	不检索
海南琼中天气	不检索
琼中景点	不检索
琼中景点	黎母山森林公园
黎母山森林公园	黎母山森林公园交通
玩游戏的好处	不检索
手游推荐	不检索
小仙女	女生手游推荐
奇迹暖暖	奇迹暖暖
奇迹暖暖下载	下载奇迹暖暖
倚天屠龙记张无忌	倚天屠龙记张无忌
射雕英雄传	射雕英雄传简介
射雕英雄传	射雕英雄传人物
黄蓉郭靖的欢喜结局	金庸武侠三部曲
神雕三部曲	神雕瞎侣
海上钢琴师	海上钢琴师的简介
1900的性格	1900的性格
海上钢琴师的感人之处	海上钢琴师的感人之处
海上钢琴师的感人之处	海上钢琴师的深刻含义
《海上钢琴师》的影响	不检索
海上钢琴师	不检索
毕节景点	毕节景点
奢香博物馆	奢香博物馆
奢香博物馆	奢香博物馆
奢香博物馆门票	不检索
奢香博物馆门票	不检索
国外电影	不检索
二战电影	奥斯卡关于二战的电影
犹太人电影	不检索
《美丽人生》	电影钢琴师男主演
《钢琴师》	电影《钢琴师》
《钢琴师》	不检索
百度公司	百度公司
进百度公司实习	如何进入百度公司实习
实习岗位	不检索
面试注意事项	不检索
创业的注意事项	云南省的创业环境
结婚的年龄	不检索
孩子的父母	不检索
养小孩难吗	不检索
尿布湿为什么贵	尿布湿价格
母乳喂养的奶粉价格	奶粉价格
母婴用品	母婴用品
恩施景点	恩施景点
恩施电视	恩施特色旅游
土家掉渣饼	土家掉渣饼
恩施美食	不检索
恩施美食	土家族美食
狗狗食欲不振的原因	啊，狗狗食欲不振是为什么？
狗狗食欲不振的原因	不检索
好吃的狗粮	好吃的狗粮品牌。
贵的狗粮	不检索
小孩儿吃磨牙棒的危害	不检索
广西玉林天气	不检索
广西天气	不检索
下雨天在家	不检索
追剧	追剧推荐
开端电影	开端白敬亭
同居的好处	不检索
同居的好处	太早同居的危害
情侣同居的好处	不检索
恋爱经验	情侣在一起多久可以同居
同居的好处	不检索
越南球	不检索
什么是越位	什么是越位
什么是越位	不检索
足球进球无效	足球进球无效种类
手球判罚	足球手球判罚
足球注意事项	不检索
医护人员在疫情期间的感人经历	不检索
医生的责任	医生在疫情期间伟大责任
值得尊敬的职业	值得尊敬的职业
光荣的人民教师	不检索
教师资格证	教师的性格要求
河南省三门峡市考试时间	不检索
日语能力考试	日语能力考试难吗
日语能力考试	不检索
日语能力考试报名费	日语能力考报名费是多少钱
日语能力考试报名费	不检索
巧克力口味的零食	不检索
巧克力口味的零食	巧克力的好处
巧克力热量高的原因	吃巧克力的危害
吃巧克力的危害	不检索
减肥的方法	不检索
拉伸运动	拉伸运动的好处
曹雪芹	曹雪芹生平
曹雪芹的人生	不检索
曹雪芹的作品	杜甫
杜甫诗	不检索
苏轼的诗	不检索
冬天穿什么衣服	不检索
保暖的羽绒服	不检索
小红书	小红书怎么用
小红书时尚博主	小红书时尚博主比例
小红书的时尚博主	不检索
艾玛斯威夫特	不检索
陈奕迅的歌	陈奕迅
陈奕迅和哪个女歌手合作过	陈奕迅和哪个女歌手合作过
张杰的歌	张杰的嗓音特点
张杰的歌	不检索
看新闻的好处	不检索
新闻的类型	新闻的类型
文教新闻	不检索
文教新闻	最近的文教新闻
孙中山故居纪念馆	不检索
穿搭小姐姐	不检索
穿搭	穿搭
时尚穿搭博主	穿搭博主
微博	微博
会穿搭的人	不检索
华晨宇的歌	不检索
烟火里的尘埃歌词	烟火里的尘埃歌词
国王与乞丐	国王与乞丐歌曲
华晨宇张碧晨	不检索
华晨宇的歌	不检索
今天天气怎么样	今天天气怎么样
甘肃的天气	甘肃的气候
温带季风气候	温带季风气候
河北省是什么气候	河北的气候
秦皇岛景点	秦皇岛的景点
北戴河	北戴河
速食	不检索
速食	不检索
速食	速食
速食营养不良	不检索
速食被骂	不检索
年货	年货
坚果	不检索
坚果大礼包	坚果大礼包
碧根果的营养价值	不检索
碧根果价格	不检索
过年的年货	春节假期
天津好玩的景点	不检索
美妆	美妆的魅力
化妆的好处	好用的化妆品
百雀羚	不检索
画眼线的危害	不检索
香港大学	不检索
香港大学	香港大学排名
香港大学女生多吗	香港大学男女比例
香港大学地址	香港大学地址
西九龙地铁	不检索
养生堂	不检索
北京卫视《养生堂》直播	养生堂播出时间
枸杞	枸杞功效
枸杞的功效	不检索
养生的内容	不检索
深圳电影院	不检索
《花束般的恋爱》	《花束般的恋爱》
国产剧《花束般的恋爱》	不检索
《花束般的恋爱》	花束般的恋爱内容
《花束般的恋爱》	不检索
ipad的品牌。	不检索
ipad的品牌。	不检索
ipad的价格。	ipad参数比对
ipadmini的价格。	ipadminim1香港定价
ipadmini最新版本	不检索
周杰伦	不检索
周杰伦	周杰伦
周杰伦	周杰伦外貌
周杰伦	不检索
《晴天》	不检索
护国寺庙会	护国寺庙会还开吗
护国寺庙会当年的庙会	护国寺庙会当年什么样
隆福寺庙会	隆福寺庙会还开吗
护国寺庙会	不检索
护国寺庙会现在还开吗	不检索
孙杨	孙杨兴奋剂检查
孙杨的努力	孙杨
孙杨	孙杨奥运会冠军
孙杨兴奋剂检查	不检索
孙杨兴奋剂	不检索
健康的身体	不检索
健康的运动	应该做什么来保重身体
锻炼的好处	锻炼的好处
锻炼的好处	不检索
晨跑的好处	不检索
中山市景点	不检索
中山爬山	中山附近的爬山
中山市景点	大尖山
中山市天气	中山市天气
爬山的好处	爬山注意事项
麻团	不检索
麻团	麻团糯米
麻团糯米	不检索
麻团减肥	麻团的热量
麻团热量	热量低的美食
苏州景点	苏州小众景点
苏州景点	苏州小众景点
天气	天气
露营的好处	苏州露营
上方山森林公园	石湖景区上方山森林公园
上方山森林公园	不检索
韩剧	高分韩剧
请回答1988	请回答1988
请回答1988	不检索
请回答1988主题曲	不检索
请回答1988主题曲	不检索
元宇宙的概念是谁提出的啊	元宇宙的概念是谁提出的啊
元宇宙的概念是谁提出的？	不检索
元宇宙	不检索
元宇宙	元宇宙
元宇宙	不检索
仓鼠球游戏	仓鼠球游戏
仓鼠球游戏	仓鼠球游戏发行时间
3d仓鼠球	3d游戏unity
单机游戏	不检索
仓鼠球游戏	不检索
《快乐大本营》停播了。	《快乐大本营》停播了。
你好，星期六	你好星期六
你好星期六主持人	不检索
你好星期六主持人	你好，星期六主持人阵营。
你好星期六主持人	不检索
杨超越	杨超越
杨超越的代表作	杨超越的代表曲目
杨超越的歌	不检索
锦鲤少女	不检索
锦鲤少女	不检索
智齿疼	牙疼
智齿	不检索
智齿最疼的部位	智齿
智齿智齿冠周炎	不检索
智齿智齿	不检索
篮球运动	篮球运动的好处
库里	库里
库里三分球纪录	库里三分球纪录
库里	库里身高体重
库里	库里
奥斯卡	奥斯卡2022年
奥斯卡	不检索
奥斯卡	奥斯卡
绿皮书奥斯卡	绿皮书奥斯卡
绿皮书奥斯卡	绿皮书奥斯卡
《沙丘》	提莫西查拉梅
《沙丘》	不检索
多肉怎么烹饪	不检索
多肉怎么养	不检索
多肉一个月浇一次水	不检索
多肉怎么养	不检索
多肉怎么养	不检索
高考注意事项	不检索
高考物理复习	高考物理复习
高考物理复习	高中物理课外参考书
《基础物理中的数学方法》	不检索
考试时紧张怎么办	考试时紧张怎么办
高考自我暗示	不检索
罗小黑战记	罗小黑战记番外
罗小黑战记番外	罗小黑战记
野良神	野良神
野良神	国产动画
《狐妖小红娘》	庹小新
《我是歌手》	不检索
爱情电影	经典爱情电影
《当哈里遇见萨莉时》	《当哈里遇见萨莉时》
《当哈里遇见萨莉时》的时间跨度	不检索
《当哈里遇见萨莉时》	不检索
北京的交通怎么样	北京的交通状况
北京交通设施	不检索
过街天桥	过街天桥的不合理地方
残障人士交通	不检索
北京交通调研报告	不检索
刘翔	刘翔
刘翔退役	刘翔退役的原因
刘翔的运动生涯	刘翔介绍
刘翔离婚	刘翔离婚
新的中国跨栏明星	不检索
菊花	不检索
菊花泡水的功效	菊花泡水美颜养容，菊花水中含有氨基酸、黄酮类物质、维生素和其他微量元素等物质，可以美颜养容
皮肤好的中药	皮肤
保护皮肤	保护皮肤
喝水的好处	不检索
吃红烧肉的好处	不检索
家常菜	不检索
鱼香肉丝	鱼香汁
麻婆豆腐的做法	麻婆豆腐
麻婆豆腐做法	不检索
袁承志	袁承志
碧血剑袁承志	不检索
碧血剑情节	碧血剑情节
碧血剑	不检索
碧血剑	不检索
听音乐的好处	不检索
曾经你说歌词	曾经你说歌词
《错位时空》	抖音热歌
抖音软件	不检索
配隐形眼镜还是框架眼镜	不检索
经济学专业学什么	不检索
经济学专业学什么	不检索
经济学学数学吗	不检索
经济学专业学什么	不检索
经济学考研	不检索
基金是什么	基金是什么
基金的定义	不检索
什么是基金	理财产品有哪些
理财的意义	不检索
理财的好处	不检索
比特币	比特币
元宇宙	元宇宙
元宇宙里用什么钱	元宇宙地产
qq币	不检索
web3.0	web3.0
铜仁市景点	附近的景点
大明边城	大明边城的简介
酷刑	酷刑
现代社会的酷刑	现代社会还有酷刑吗
酷刑	大明边城
铜仁市景点	铜仁市的景点
过年吃什么	过年吃什么
过年吃什么	过年有什么好吃的
腊肉	腊肉做法
腊肉	不检索
过年春联	虎年春联
面包机	不检索
面包怎么发酵	面包怎么发酵
中种法	中种法怎么做
面包怎么做	不检索
面包怎么做	不检索
做菜的好处	不检索
做菜的技巧	做菜需要注意什么
做菜的注意事项	做菜的注意事项
做菜的注意事项	炒菜的注意事项
做菜的注意事项	不检索
冬奥会时间	冬奥会什么时候开始
北京冬奥会	北京冬奥会什么时候开
冬奥会吉祥物	冬奥会吉祥物详细介绍
北京冬奥会门票	不检索
冬奥会项目	不检索
三重门	韩寒三重门介绍
韩寒三重门	韩寒三重门介绍
韩寒	韩寒
韩寒	韩寒
韩寒	韩寒
大同市天气	不检索
游泳的好处	游泳好处
游泳的好处	跑步的好处
泳衣价格	不检索
大同市购物商场	不检索
银行的好处	不检索
银行卡	不检索
银行工作	中国银行怎么样
邮政储蓄银行	中国邮政储蓄银行怎么样
中国邮政储蓄银行	不检索
logo的含义	logo的作用
品牌的定义	品牌是什么
logo的作用	logo如何设计
衣服的品牌	关于衣服的品牌
小公司的服装品牌	不检索
清远市的服装品牌	广东省清远市有什么好的衣服牌子吗？
晨跑的好处	晨跑的好处
晨跑减肥	晨跑的好处
晨跑app	晨跑注意事项
不吃早饭减肥	不检索
晨跑拉伸运动	不检索
养小宠物的好处	不检索
孔雀鱼	孔雀鱼
孔雀鱼	不检索
孔雀鱼好养活吗	孔雀鱼好养活吗
孔雀鱼好养活吗	不检索
lol赛事	不检索
lol世界赛	lol赛事
lol世界赛	不检索
斗地主	斗地主
植物大战僵尸	不检索
容祖儿的歌	容祖儿
容祖儿的歌	容祖儿出名的歌
容祖儿的粤语歌	容祖儿的粤语歌
容祖儿的粤语歌	不检索
容祖儿的国语歌	不检索
专科学校老师	不检索
广州专科学校	广州专科学校
广州美食	广州的美食
广州气候	广州气候
广州的气候	不检索
小时候看的书	不检索
杨红樱	杨红樱
郑渊洁的书	郑渊洁
郑渊洁的房子	不检索
郑渊洁	不检索
喜欢做运动的好处	不检索
运动的精气神	不检索
羽毛球拍	健身运动羽毛球
打乒乓球的好处	自己打的乒乓球单人乒乓球
乒乓球的好处	不检索
朔州景点	朔州的景点
应县木塔	应县木塔
应县木塔	应县木塔
应县木塔门票	应县木塔的门票
应县木塔	不检索
火龙果被隔离	不检索
火龙果疫情	火龙果疫情
疫情水果供应	疫情水果供应
吃火龙果的危害	疫情特效药
疫情下吃水果的危害	不检索
吃水果的危害	疫情风险意识
天津景点	天津好玩的景点
天津景点	不检索
意式风情区	不检索
天津的特色美食	天津的特色美食
津门三绝	不检索
牙疼	牙疼的原因
心脏病引起牙疼	牙疼心脏
牙疼原因	不检索
牙周炎是什么	牙周炎
牙髓炎	牙髓炎
穿搭风格	不检索
学穿搭的方法	不检索
学穿搭的好处	运动配饰
李宁特步迪卡侬彪马	不检索
穿搭的技巧	认识女生多久可以邀请对方吃饭
王者荣耀	不检索
《王者荣耀》	《王者荣耀》怎么玩
《第五人格》	《第五人格》
《第五人格》	不检索
开心消消乐	不检索
植物大战僵尸	植物大战僵尸
微博	微博
新浪微博	新浪微博
微博的好处	不检索
微博电影	不检索
微博的好处	不检索
ipad画画	ipad画画
冒菜	不检索
冒菜和麻辣烫有什么区别	冒菜和麻辣烫有区别吗
麻辣烫的种类	麻辣烫是哪个菜系
麻辣烫的种类	不检索
麻辣烫的种类	不检索
余华	余华
余华的作品	余华
余华的第七天	不检索
余华的第七天	余华的第七天
余华的作品	不检索
嗓子痛	姜汤
感冒吃什么药	感冒吃什么药
板蓝根可以吃吗	板蓝根可以吃感冒
感冒吃什么药	感冒多久能好
感冒吃什么药	不检索
王者荣耀钻石	王者荣耀
王者荣耀	王者荣耀钻石等级
王者荣耀	类似王者荣耀的手游
王者荣耀升级	王者荣耀升级技巧
王者荣耀水水经验	不检索
就业教师	不检索
当老师的好处	当老师的好处
教师资格证面试	教师资格证面试准备
教师资格证考试时间	加强自信心
教师资格证面试	不检索
古典舞	不检索
只此青绿	舞蹈只此青绿评价
古典舞	古典舞特点
古典舞	不检索
古典舞的难度	不检索
舟山市天气	不检索
舟山市天气	不检索
网络小说	辰东完美世界小说介绍
小说《完美世界》作者	辰东
辰东	不检索
辰东	不检索
清明节南京景点	南京景点
南京的美食	南京特色美食
盐水鸭	不检索
南京的美食	不检索
夫子庙美食店	不检索
过年吃什么零食	不检索
好吃的零食	买零食的最便宜的网站
零食品牌	好吃的零食品牌
三只松鼠	不检索
三只松鼠	不检索
《魔戒》	电影《魔戒》
《魔戒》	不检索
精灵	《指环王》中的精灵
阿拉贡人王	不检索
《魔戒》	《魔戒》《霍比特人》
《精灵宝钻》	《精灵宝钻》
羽毛球比赛	不检索
羽毛球专业	羽毛球进国家队有多难
羽毛球馆	羽毛球业余高手
羽毛球馆	不检索
羽毛球老师	不检索
买基金的好处	基金
买基金的好处	不检索
白酒基金	白酒基金
什么基金好赚钱	基金
买基金的方法	不检索
烟台美食	不检索
吃西餐的好处	附近美食城
海鲜	海鲜店
山东草莓	山东草莓
烟台天气	不检索
李泽楷	不检索
学过专业表演的演员	不检索
杨幂	杨幂
杨幂三生三世十里桃花	不检索
赵又廷	赵又廷的作品
澳门景点	澳门景点
澳门景点	澳门美食
礼品店	不检索
澳门住宿	澳门住宿
澳门酒店一天的价格。	澳门金沙酒店价格
做菜的好处	不检索
做菜的量	不检索
京酱肉丝	京酱肉丝
京酱肉丝	不检索
简单家常菜	家常菜有哪些
家常菜	不检索
山西籍的运动员	山西籍的运动员
山西籍的运动员	山西籍的奥运冠军
奥运冠军张国政	奥运冠军张国政
张国政	不检索
张国政	不检索
跑步的好处	不检索
跑步的好处	运动好处
跑步的好处	坚持跑步原理
晚上跑步	夜跑时间
晚上跑步时间	睡前运动时间
成为一名宇航员	中国成为一名宇航员的要求
在中国的国家是怎么选拔宇航员的	不检索
宇航员年龄	不检索
如何成为一名宇航员	不检索
美国的宇航员	不检索
白羊座	白羊座
白羊座的特点	白羊座的男生有什么特点
白羊座的人格魅力	不检索
白羊座和什么星座最配	白羊座男生和什么星座最配
白羊座女生	不检索
泰州市中学	不检索
泰州市高中	泰州市高中
泰州市中考分数线	不检索
泰州市高中	泰州市高中
泰州市高中	不检索
建党100周年活动	不检索
嘉兴南湖红船	嘉兴南湖红船
嘉兴南湖红船	红船精神
红船精神	红船精神的实践意义
南湖红船	不检索
成都景点	成都景点
都江堰怎么去	都江堰交通
成都景点	不检索
驾照科目二考试	不检索
倒库、侧方停车、s弯道	不检索
冬奥会	不检索
花样滑冰比赛	羽生结弦
羽生结弦	羽生结弦挑战4a失败
花样滑冰4a难吗	花样滑冰4a难吗
羽生结弦	不检索
安康的景点	不检索
安康景点	不检索
接下来一周天气	接下来一周天气怎么样
安康天气	不检索
陕西安康的室内景点	陕西安康的室内景点
舞蹈风暴	舞蹈风暴
舞蹈风暴谢欣	舞蹈风暴谢欣
《舞蹈风暴》谢欣	不检索
爵士舞	知名爵士舞者
迈克尔杰克逊	不检索
仪式感幸福指数	仪式感
鲜花的意义	鲜花
玫瑰	玫瑰
多头玫瑰	不检索
生活中做什么让幸福指数上升	不检索
生活的意义	生活
养生的好处	不检索
办公室久坐	不检索
颈椎不健康的表现	颈椎病
腰酸背疼的原因	不检索
颈椎相关的疾病经常会头晕眼花、身体乏力、腰	如何缓解颈椎病？
世界名著推荐	不检索
马尔克斯百年孤独	马尔克斯百年孤独
马尔克斯百年孤独	不检索
海明威的短篇集	不检索
海明威	海明威
海明威	不检索
便当的种类	不检索
糖醋小排	糖醋小排
糖醋小排	不检索
西蓝花的颜色	西蓝花炒得颜色亮
西蓝花炒的诀窍	不检索
宠物的常见病	宠物的常见病
小狗身上有虫	不检索
宠物店的服务	宠物店有哪些服务
宠物医院	不检索
老人容易得的基础病	老人容易得的基础病
双十一优惠	不检索
纸巾品牌	在哪个网站上面买纸巾最便宜
拼多多纸巾	不检索
拼多多纸巾品牌	哪个牌子的卫生纸最好用
洁柔纸巾	不检索
苏炳添	苏炳添
苏炳添	东京奥运会苏炳添
苏炳添	苏炳添的课程
苏炳添	苏炳添的成就
苏炳添	苏炳添的努力
苏炳添	不检索
健康的身体	不检索
相信中医的人。	中医
中医的优点	中医的优势
中医的优点	中医的缺点
中医的优点	不检索
广东水果	广东产的水果
佛山水果价格	佛山水果价格
广东水果	不检索
黄皮果	黄皮果
黄皮果吃不胖	不检索
感冒的原因	不检索
感冒的原因	不检索
感冒吃什么药	不检索
感冒吃什么药	不检索
感冒吃什么药	不检索
学习做饭的方法	不检索
麻婆豆腐	不检索
川菜	川菜推荐
川菜上火	川菜上火
川菜推荐	不检索
做饭的好处	烹饪
可乐鸡翅	可乐鸡翅
可乐鸡翅视频教程	不检索
学习可乐鸡翅的方法	不检索
可乐鸡翅	不检索
可乐鸡翅	不检索
出国留学	不检索
韩国留学费用	马来西亚气候
马来西亚高校	马来亚大学
在马来西亚可以说汉语吗？	马来西亚语言
马来亚大学	不检索
广元市水果	广元市水果
广元市水果	不检索
旺苍椪柑	旺苍椪柑
苍溪雪梨	苍溪雪梨
苍溪雪梨	不检索
河池市天气	不检索
旅行的好处	不检索
海边旅行	海边旅行地区
三亚海边	三亚海边怎么样
三亚景点	不检索
北大和清华哪个更好	北大和清华哪个更好
北大和清华哪个更好	不检索
北大和清华哪个更好	不检索
北大和清华哪个更好	河南高考难度
高考压力	不检索
海子	不检索
海子	海子北京大学
海子	海子
屈原	屈原为何投江
屈原	不检索
lululemon	lululemon
lululemon	不检索
lululemon价格	lululemon为什么贵
lululemon	不检索
lululemon	不检索
玫瑰山楂条	玫瑰山楂条
金晔原汁玫瑰山楂条	玫瑰山楂条做法
山楂条的营养价值	山楂条口味
山楂条经常吃	山楂条经常吃
山楂吃多了会上火吗	不检索
半身裙搭配什么上衣好看	半身裙搭配什么上衣半身裙搭配什么上衣
半身裙搭配运动鞋	半身裙应该搭配运动鞋还是高跟鞋
白色裙子搭配什么颜色的鞋子	不检索
早上去哪里买衣服	不检索
湖北襄阳市天气	不检索
三体广播剧	三体广播剧
三体广播剧	三体刘慈欣
三体电影版	三体电影版
三体电影版	三体电影版
三体电影版	三体简介
三体特效	不检索
茶颜悦色	茶颜悦色
奶茶成瘾	喝奶茶的危害
养生的茶	养生的茶类
红茶的好处	喝红茶的好处
喝奶茶的次数	不检索
足球课	不检索
踢足球的好处	不检索
北京哪里有足球场	不检索
足球训练	不检索
踢几人制	不检索
李易峰	不检索
李易峰的剧	李易峰的电视剧
李易峰的作品	不检索
《怦然星动》	不检索
《怦然星动》	不检索
伦敦疫情	不检索
英国伦敦景点	伦敦
伦敦的景点	英伦
英国伦敦的景点	神探夏洛克
英国伦敦的景点	不检索
英国经常下雨	不检索
养小狗的好处	不检索
家里养小狗的空间	小型犬
小狗掉毛	小狗掉毛
小狗清理卫生状况	小狗打疫苗
小狗为什么容易掉毛	不检索
有机化学	不检索
芳香烃亲电取代反应的邻对位定位基团都是	不检索
为什么苯环和苯环的钝化基团是活化基团	苯环钝化
苯环上的卤素既是邻对位定位基团又是钝化基团	不检索
苯环怎么做亲电取代	苯环自由基取代
苯环自由基取代	苯环的自由基取代
苯环的自由基取代	不检索
张碧晨的唱腔独特	张碧晨唱腔独特
张碧晨可以当演员吗	不检索
张碧晨和张杰合作的歌曲	我不是药神张碧晨
最难治的病就是穷病	不检索
如何帮助家庭解决生活困难	不检索
爱情的定义	不检索
泰坦尼克号	不检索
小李子	小李子
莱昂纳多	莱昂纳多作品
莱昂纳多的作品	不检索
水仙花好养吗	水仙花好养吗
好养又好看的花	好养又好看的花
茉莉花多少钱一盆	茉莉花多少钱一盆
江门茉莉花多少钱一盆	不检索
茉莉花多少钱一盆	不检索
诗歌朗诵大会	不检索
诗歌朗诵作品	不检索
李白	杜甫诗的特点
杜甫的诗	杜甫
杜甫的诗	不检索
冬天穿搭	不检索
穿搭博主	穿搭博主
冬天穿搭	冬季御寒
淘宝天猫双十一活动	不检索
溜肉段怎么做	不检索
溜肉段	不检索
溜肉段	不检索
炸两遍的猪肉	复炸
溜肉段做法	不检索
溜肉段的口味	不检索
警犬	德牧
德牧好养吗	养德牧的花销
养狗的花销	不检索
德牧	不检索
德牧	不检索
莫言诺贝尔	莫言诺贝尔
莫言	莫言
莫言本名	不检索
莫言的第一部作品	莫言诺贝尔
莫言的作品	莫言诺贝尔
荆州大学	不检索
毕业以后要做什么	不检索
出版社专业	出版社工作
出版社的文字工作	不检索
出版装帧设计	出版装帧设计
巧克力的好处	不检索
巧克力的代可可脂	巧克力品牌
德芙	德芙哪些口味
巧克力品牌	不检索
巧克力的口味	不检索
烧烤的好处	辽宁省辽阳市有哪些烧烤店
辽阳市天气	不检索
辽阳市天气	辽宁省辽阳市未来十五天天气
户外烧烤	不检索
户外烧烤需要准备的材料	户外烧烤需要准备的材料
临期化妆品	不检索
化妆品过期会怎样	化妆品过期会怎样
过期一两天能用吗	化妆品过期一两天能用吗
临期化妆品价格	不检索
化妆品的保质期	不检索
滨州市天气	滨州市天气
滨州市天气	不检索
陈坤电视剧	陈坤电视剧
陈坤	龙门飞甲
钱学森	陈坤钱学森
陈坤	不检索
阳江海边	阳江海边景点
阳江珍珠湾	珍珠湾天气
阳江天气	不检索
阳江天气	不检索
阳江天气	不检索
只此青绿	只此青绿春晚
青绿腰	青绿腰只此青绿
只此青绿腰	只此青绿演出
永恒消失的电波舞剧	不检索
民族舞	不检索
宁夏景点	宁夏景点
沙坡头	沙坡头游玩项目
羊皮筏子	羊皮筏子
羊皮筏子安全吗	羊皮筏子安全吗
羊皮筏子安全吗	不检索
四大名著	不检索
红楼梦	不检索
红楼梦电视剧	红楼梦最出名的电视剧版本
红楼梦版本	红楼梦电视剧版本
李沁	李沁的作品
《楚乔传》的评价	不检索
短跑运动员	不检索
短跑练习	不检索
苏炳添	苏炳添的伟大比赛
苏炳添	不检索
短跑练习	怎么练习短跑
许昌市天气	许昌市天气
许昌市天气	不检索
黑龙江现在下雪了吗	黑龙江天气
河南许昌市景点	不检索
滑雪	滑雪
北京奥运会	北京奥运会
2008年夏季奥运会和今年冬季奥运会有什么不同	夏季冬季奥运会不同
人造雪和自然降雪有什么区别	人造雪天然雪区别
人造雪和天然雪的区别	新乡滑雪场
新乡天气	不检索
背诗的方法	不检索
李白的诗	李白
将进酒李白	将进酒李白
李白的诗	李白蜀道难
李白的诗	背诗的技巧
广东的房价	广东的房价
北上广深房价	北上广深房价贵的原因
大学生买房优惠	应届大学生买房有优惠嘛
买房的小技巧	买房的小技巧
一家四口适合什么户型	一家四口适合什么户型
鲍勃迪伦诗歌集	鲍勃迪伦诗歌集
鲍勃迪伦	鲍勃迪伦
国外的作家	不检索
国内的诗歌	推荐的国内的诗歌
面朝大海，春暖花开	不检索
整容的好处	整容
整容的方法	不检索
化妆品品牌	化妆品
粉底液品牌	粉底液品牌
圣罗兰粉底液	圣罗兰粉底液
洗脸巾推荐	洗脸巾推荐
全棉时代洗脸巾	全棉时代洗脸巾
全棉时代洗脸巾	全棉时代洗脸巾价格
洗脸巾品牌	洗脸巾使用
湿敷	不检索
疫情	不检索
走近科学	走近科学什么时候开播的
走近科学的前身	走近科学讲了什么
走近科学讲了什么	不检索
走近科学节目	不检索
科教片	不检索
鸡胸肉做什么菜	鸡胸肉可以做什么菜
宫保鸡丁	宫保鸡丁
宫保鸡丁的配料	宫保鸡丁
宫保鸡丁	不检索
宫保鸡丁做法	鸡胸肉的营养价值
刘亦菲	刘亦菲外形
刘亦菲的作品	刘亦菲的作品
《天龙八部》	《天龙八部》中刘亦菲扮演的谁
《仙剑奇侠传》	不检索
刘亦菲的努力	不检索
乌克兰原来是俄罗斯的一部分吗？	乌克兰原来是俄罗斯的一部分吗？
乌克兰跟俄罗斯关系	不检索
乌克兰历史	乌克兰建国多久了？
乌克兰建国史	不检索
俄罗斯和北约的战略目标	不检索
最近上映的电影	最近电影院上映的电影有哪些
唐七公子	不检索
刘昊然	刘昊然
刘昊然	不检索
张子枫	张子枫
黄山市景点	黄山市
黄山	黄山简介
黄山的景点	黄山简介
黄山的主峰	黄山简介
黄山上的树	迎客松
刘奕君揩油	不检索
刘奕君	不检索
刘奕君的演技怎么样	刘奕君的剧
刘奕君的电视剧	刘奕君《父母爱情》
刘奕君演的欧阳懿	刘奕君演的欧阳懿怎么样
刘奕君的演技	刘奕君怎么提高演技
杨颖的长相	不检索
杨颖的奢侈品品牌	不检索
杨颖的英语口语	杨颖演的电视剧
杨颖黄晓明离婚	杨颖黄晓明离婚
杨颖和黄晓明离婚	不检索
跑步的好处	不检索
铜仁市天气	不检索
铜仁市天气	铜仁市近15天温度
铜仁市天气	铜仁市跑步路线
马拉松	不检索
吃零食的好处	不检索
吃零食的坏处	节食注意
水果含糖量高	水果节食
减肥的水果	不检索
减肥的方法	明天空气质量
中医的好处	中医能治腰酸背痛吗
拔罐	推拿的历史
拔罐	拔罐
拔罐点火	拔罐点火
拔罐注意事项	不检索
中国女排	《中国女排》
中国女排	《中国女排》
郎平	郎平
中国女排运动员	不检索
学习的方法	不检索
星座	星座
摩羯座	魔羯座
魔羯座	不检索
金牛座	金牛座
陶白白	不检索
陶白白	不检索
找不到合适的女青年	剩女
中国男女比例	中国男女比例
中国男女比例	中国老龄化
中国老龄化	不检索
找不到女朋友的原因	不检索
养宠物的好处	不检索
养狗的时间	不检索
养猫必需品	养猫必需品
猫爬架	猫爬架作用
养猫绝育	养猫绝育
养猫绝育费用	猫绝育价格
唇泥	唇泥
唇泥的牌子。	唇泥的牌子
intoyou唇泥颜色	intoyou唇泥颜色
intoyou橄榄皮唇泥	不检索
唇泥颜色	不检索
多肉的品种。	多肉的种类
罗密欧多肉	不检索
紫珍珠是紫色的吗	不检索
养多肉的方法	不检索
花店多肉	不检索
简爱	简爱名著书评
简爱作者	简爱作者
简爱三姐妹	简爱姐妹作家
爱玛	爱玛名著
安娜卡列尼娜	不检索
减肥的好处	不检索
有氧运动	不检索
跑步减肥	减肥有哪些要注意的事情
有氧运动的好处	不检索
减肥的方法	不检索
李泽楷。	不检索
杨颖和黄磊结婚	不检索
杨颖和黄晓明的绯闻	不检索
杨颖的长相	杨颖
杨颖演过什么电影	杨颖演过什么电影
抓流浪猫	为什么要抓流浪猫
被流浪猫咬伤	不检索
流浪猫	不检索
流浪猫做绝育	猫做绝育有什么好处
厦门流浪猫领养	不检索
美国的景点	美国的景点
世界上的迪士尼	世界上的迪士尼
上海迪士尼	不检索
上海迪士尼	不检索
上海迪士尼	上海迪士尼的淡季是什么时候
东京的迪士尼	东京的迪士尼
手工的好处	可以做哪些手工
手工十字绣	手工十字绣为什么有趣
手工十字绣好处	不检索
拼图游戏	不检索
拼图游戏	不检索
羊角蜜	哈密瓜
羊角蜜	不检索
吃瓜拉肚子	吃瓜拉肚子
吃菠萝嘴巴疼	吃菠萝嘴巴疼
吃菠萝嘴巴疼	不检索
黄金屋	不检索
木桶泡脚	泡脚木桶
樟木是什么木头	樟木木桶
泡脚的好处	泡脚好处
泡脚的好处	一起泡脚
艾草泡脚	艾草老人泡脚
艾草的好处	不检索
玩游戏被嫌弃	不检索
剧本杀	剧本杀
剧本杀	香港天气
玩游戏的好处	不检索
哥哥玩游戏	不检索
俄罗斯文学	俄罗斯文学
托尔斯泰	俄罗斯文学
托尔斯泰	托尔斯泰
托尔斯泰	托尔斯泰
托尔斯泰的作品	托尔斯泰
泡脚的好处	不检索
泡脚	泡脚养生
泡脚的好处	泡脚按摩
养生的男女比例	不检索
拔罐疼吗	拔罐适合人群
泡脚的好处	泡脚的好处
泡脚时间	不检索
泡脚放什么药	泡脚放什么
自动洗脚盆	自动洗脚盆好用吗
牛奶泡脚	不检索
许嵩的歌	不检索
许嵩的歌	许嵩的歌
许嵩	不检索
我的音乐你听吗	音乐综艺
音乐节目推荐	不检索
《歌手》	音乐节目《歌手》
苏炳添	不检索
苏炳添	苏炳添
小米	不检索
雷布斯	小米最高奖
小米的产品	不检索
紫苏阳台	不检索
紫苏阳台	紫苏阳台
紫苏的叶子可以入药吗	紫苏阳台
紫苏茶做法	不检索
紫苏叶子	不检索
紫苏养护	紫苏养护
看电影的好处	喜剧片有哪些
《小鬼当家》	《小鬼当家》
《今天我休息》	不检索
零食	不检索
晚上看电影的时候吃零食	不检索
零食的好处	不检索
山姆的甜品	山姆店
山姆沃尔顿	山姆店价格
山姆零食	不检索
山姆年年销量	不检索
花王堂	风信子
风信子	风信子家
风信子好养吗	好养的花
太阳花	太阳花价格
太阳花	不检索
霍建华	霍建华
霍建华演的电视剧	霍建华演的电视剧
《他来了请闭眼》	《他来了请闭眼》
薄靳言	不检索
《他来了请闭眼》的资源	不检索
秦皇岛水果	不检索
春天应季的水果	春天应季水果
杨桃	杨桃
超市水果	今天天气
明天天气	不检索
余华	余华
余华	《活着》的简介
余华	不检索
余华的作品	不检索
余华的性格	作家余华的性格
余华的书	余华
怀孕的原因	不检索
怀孕经验	怀孕经验
孕吐的原因	孕吐跟孩子性别
孕吐和胎儿性别有关系吗	不检索
孕吐和胎儿性别有关系吗	不检索
苏炳添	苏炳添打破纪录
100米世界第一	100米世界第一
刘翔	刘翔
中国游泳冠军	中国游泳冠军
中国游泳运动员	不检索
电视剧	新出的好看的电视剧
庆余年郭麒麟	不检索
现代电视剧	好看的现代电视剧
想见你	想见你的男女主演想见你的男女主演
想见你电视剧	不检索
四大名著	四大名著是什么
四大名著	西游记的nei
西游记电视剧	不检索
西游记电视剧	不检索
红楼梦的版本	电视剧红楼梦的经典版
适合写的书	不检索
灵感的培养	灵感是稍纵即逝的
看电影的想法	不检索
看电影的功利心	不检索
写东西的方法	不检索
推荐的电影	推荐的电影
冬奥会	不检索
花样滑冰冠军	不检索
羽生结弦	羽生结弦获得过的奖项
4a是什么	阿克塞尔四周跳
羽生结弦挑战4a	不检索
养生的好处	不检索
眼睛干涩	如何缓解眼部疲劳
眼部疲劳的原因	不检索
坚持不下来的原因	不检索
护眼的方法	不检索
潍坊的气候	潍坊市有几个区县
潍坊	不检索
潍坊	潍坊做风筝最有名的地方
风筝之乡	不检索
风筝	不检索
备孕期间应该注意什么	备孕期间应该注意什么
怀孕期间需要注意什么	怀孕期间需要注意什么
养新生儿要注意什么	养新生儿要注意什么
宝宝的衣服布料	婴儿的衣服布料
婴儿的衣服布料	不检索
四大名著	不检索
外国的四大名著	外国四大名著
西方的四大名著	外国的四大名著
《荷马史诗》和莎士比亚的《哈姆雷特》	不检索
学习名著的方法	读名著的作用
养生的意义	养生
00后养生	不检索
枸杞的好处	养生
养生的方法	养生
养生的方法	不检索
养生的好处	不检索
扫地机器人	扫地机器人
扫地拖地一体化	扫地拖地机器人
扫地机器人	不检索
人工智能	人工智能应用
机器人会背叛我们人类嘛	机器人会背叛我们人类嘛
印度电影	出名印度电影
《三傻大闹宝莱坞》的男主演	三傻大闹宝莱坞
阿米尔汗	印度电影特点
印度的传统服装	印度民族服装
去印度玩	不检索
核磁共振的原理	核磁共振原理
核磁共振	核磁共振
核磁共振水	不检索
核磁共振可以用来干什么	核磁共振
核磁共振原理	不检索
什么体操最耗卡路里	什么体操最耗卡路里
杠铃操	什么体操最耗卡路里
杠铃操运动注意事项	杠铃操运动注意事项
健身房的教练	不检索
健身房的注意事项	不检索
安家庄	不检索
孙俪	孙俪
孙俪	孙俪
孙俪出道	不检索
玉观音	不检索
早上吃什么	不吃早餐的危害
早上精神	不检索
早上做什么早餐比较健康	健康的早餐
早上做什么早餐比较健康	简易早餐
花生酱面包	不检索
玉树县	玉树县
玉树	玉树地震
玉树地震	玉树地震
玉树景点	玉树景点
玉树美食	玉树美食
麒麟生鱼片	麒麟生鱼片
脖子难受	不检索
针灸推拿	不检索
针灸推拿	脖子酸疼针灸
推拿按摩	推拿按摩
推拿的副作用	不检索
兴趣爱好	兴趣爱好
追剧	不检索
火影	《火影》
《火影》	不检索
海贼王	《海贼王》
国外电视剧	英剧
绅士和淑女	英国绅士
绅士的优点	不检索
甜茶	timotheechalamet
纽约的一个雨天	纽约的一个雨天
纽约的一个雨天	不检索
宠物猪	宠物猪的品种
迷你香猪	迷你香猪怎么当宠物猪养
迷你香猪	不检索
迷你香猪	不检索
养猫的好处	不检索
加班的原因	不检索
加班的原因	内卷
内卷的原因	同事的内卷
内卷的危害	内卷的影响
如何应对内卷	对付内卷的方法
内卷的危害	不检索
感冒	感冒的症状
淋雨的原因	淋雨后怎么办
感冒吃什么药	感冒吃什么药
感冒吃什么药	不检索
新疆天气	新疆维吾尔自治区和田地区天气
保研	保研
保研专业第一	保研专业第一
保研专业第一	保研外投
外投	保研外投
保研经验	中国科学院大学
保研专业	不检索
音乐制作学什么	不检索
混音是什么	混音指的什么
混音要调整什么	混音要调整音轨频率吗
混音的动机	不检索
音乐创作的方法	不检索
潍坊今天天气	不检索
潍坊天气	如何看天气
北京今天的天气	今天北京天气
未来7天北京的天气	未来7天北京天气
旅行的好处	不检索
北京的自然景观	北京的自然景观
香山樱桃沟	香山樱桃沟
植物园门票	植物园门票
植物园门票	不检索
植物园门票	不检索
江西省南昌市天气	附近天气
最近的天气	最近天气
江西明天天气	不检索
哈尔滨冰雕	不检索
哈尔滨冰雕订票	不检索
哈尔滨的草莓超市	不检索
冬季水果	不检索
草莓的营养价值	草莓好处
草莓价格	不检索
草莓的品种	草莓什么品种比较好吃
草莓的品种	不检索
青春一去不复返	怀念青春
青春是美好的岁月	青春一去不复返
去哪里看老师	去学校看老师
老师的责任	不检索
老师可以记得你吗	不检索
校服的意义	校服的含义
金钱豹	西游记金钱豹
西游记	西游记四大名著
西游记作者	西游记作者
西游记翻拍	西游记翻拍
西游记翻拍	西游记翻拍
四大名著	四大名著
金玉良缘木石前盟	金玉良缘木石前盟
红楼梦	不检索
红楼梦电视剧版	新版电视剧《红楼梦》
红楼梦中人大型选秀活动	红楼梦中人大型选秀活动
吃零食的危害	不检索
薯片	吃薯片的危害
上火的零食	吃零食上火怎么办
过年吃什么零食	不检索
过年在家做什么	过年在家有趣的活动
过年玩游戏	不检索
陈奕迅	不检索
陈奕迅	陈奕迅代表作
浮夸演唱	浮夸演唱很难的原因
陈奕迅的歌	陈奕迅哪首歌最难
陈奕迅的歌	不检索
《平原上火焰》	平原上火焰
《平原上火焰》	不检索
最近的电影	不检索
四海电影	电影四海
刘昊然	电影四海
《四海》	不检索
丧偶式育儿	丧偶式育儿
丧偶式育儿	不检索
丧偶式育儿的危害	不检索
育儿的成本	育儿的成本有多幸苦
丧偶式育儿	不检索
北语	不检索
北京语言大学	没听说过北语
北京语言大学	北语特色
北京语言大学	不检索
英语考试	不检索
零食店	低卡零食
零食的好处	不检索
吃零食的危害	不检索
健康零食	低卡零食
健康零食	不检索
小香猪和草原上的牛羊相处	小香猪
小香猪的寿命	小香猪延长寿命
小香猪生病兽医	小香猪生病兽医
脉搏失律	脉搏失律小香猪
兽医小香猪	兽医新疆
兽医	不检索
贵州美食	贵州美食
花溪牛肉粉	花溪牛肉粉
花溪牛肉粉	今日天气
贵州美食	不检索
吃美食的好处	不检索
时尚品牌	不检索
时尚品牌	时尚品牌
简约的服装品牌	简约的服装品牌
国潮	不检索
最近国潮流行的款式	不检索
许嵩综艺	不检索
我的音乐你听了吗	许嵩
我的音乐你听了吗	我的音乐你听了吗嘉宾
我的音乐你听了吗	不检索
k歌	不检索
苹果手机优惠	不检索
苹果手机的学生优惠	苹果手机教育优惠
拼多多手机	苹果手机拼多多
拼多多app	不检索
拼多多旗舰店	不检索
诗歌朗诵的方法	诗歌朗诵首先考虑什么
诗歌朗诵的名字	徐志摩的诗歌作品有哪些
再别康桥的情感	《再别康桥》的情感
再别康桥的背景音乐	再别康桥适合什么音乐
《再别康桥》的背景	《再别康桥》的情感和背景
朗诵的重点	朗诵的重点
西安景点	西安景点
兵马俑	兵马俑介绍
兵马俑	兵马俑门票
西安景点	大雁塔音乐喷泉
西安夏天天气	不检索
夏天的定义	夏天
看电视剧的好处	不检索
喜欢夏天的原因	雨
淋雨的身体不太好	不检索
淋雨的方法	不检索
下雨天的浪漫	浪漫
养猪的好处	宠物猪
小香猪	宠物猪
养小香猪的注意事项	养小香猪注意事项
贵妇猪	不检索
贵妇猪	不检索
养老金的计算方式	养老金的计算方式。
什么都不交的养老金	农村老人他能得到多少养老金？
农村老人退休养老金	不检索
农村老人退休养老金	不检索
农村老人退休养老金	不检索
水浒传	不检索
宋江是怎么死的	宋江是怎么死的
宋江的外号	宋江的外号是什么
水浒传的第一回	不检索
鲁智深倒拔垂杨柳	不检索
鲁智深倒拔垂杨柳	不检索
抚顺市热干面	热干面
热干面的好处	抚顺市热干面餐馆
热干面做法	热干面做法
碱面	碱水面
碱水面保质期	碱水面保质期
衡水中学演讲	不检索
衡水中学	不检索
河北的高中	北京四中知名校友
北京四中校友	不检索
土猪拱白菜	土猪拱白菜演讲
《荆棘鸟》	《荆棘鸟》
凄美的爱情小说。	凄美的爱情小说有哪些
东野圭吾	东野圭吾
东野圭吾	不检索
东野圭吾的电影	不检索
全息摄影	全息摄影
全息照相记录过程	全息照相记录过程
全息摄影	全息摄影
学摄影的好处	学摄影的好处
学摄影的好处	不检索
摄影专业学什么	不检索
谷爱凌	谷爱凌
谷爱凌	谷爱凌学习成绩
学霸	不检索
谷爱凌的家庭	不检索
谷爱凌妈妈	不检索
过年需要清理的东西	家务机器
洗地机	家务机器人
洗地机	洗地机介绍
洗地机	洗地机优点
洗地机	不检索
魔卡少女樱	不检索
小樱哥哥	小樱哥哥
小樱哥哥	小樱哥哥
知世的衣服	不检索
知世赛高	不检索
片酬	不检索
演员的片酬	不检索
上个年代的古装剧演员	上个年代的古装剧演员
贾静雯的作品	贾静雯的作品
《至尊红颜》的扮演者	不检索
全红婵	全红婵
全红婵	全红婵成长经历
全红婵受苦	全红婵受苦
全红婵	全红婵努力
全红婵	全红婵努力
全红婵	不检索